,ID,Hours,DK1,DK2,DK
01/01/2018,1.00,0,2335,1248,3583
01/01/2018,2.00,1,2332,1204,3536
01/01/2018,3.00,2,2117,1252,3369
01/01/2018,4.00,3,2081,1313,3394
01/01/2018,5.00,4,2093,1296,3389
01/01/2018,6.00,5,2029,1175,3204
01/01/2018,7.00,6,2078,1194,3272
01/01/2018,8.00,7,2080,1280,3360
01/01/2018,9.00,8,2121,1273,3394
01/01/2018,10.00,9,2335,1260,3595
01/01/2018,11.00,10,2767,1346,4113
01/01/2018,12.00,11,2879,1346,4225
01/01/2018,13.00,12,3028,1316,4344
01/01/2018,14.00,13,3199,1392,4591
01/01/2018,15.00,14,3054,1400,4454
01/01/2018,16.00,15,3031,1390,4421
01/01/2018,17.00,16,3024,1385,4409
01/01/2018,18.00,17,3075,1357,4432
01/01/2018,19.00,18,3028,1318,4346
01/01/2018,20.00,19,2956,1288,4244
01/01/2018,21.00,20,2584,1257,3841
01/01/2018,22.00,21,2510,1242,3752
01/01/2018,23.00,22,2374,1175,3549
01/01/2018,24.00,23,2347,1085,3432
02/01/2018,25.00,0,2273,1022,3295
02/01/2018,26.00,1,2202,976,3178
02/01/2018,27.00,2,2081,895,2976
02/01/2018,28.00,3,2018,830,2848
02/01/2018,29.00,4,1966,778,2744
02/01/2018,30.00,5,1961,779,2740
02/01/2018,31.00,6,2041,836,2877
02/01/2018,32.00,7,2408,949,3357
02/01/2018,33.00,8,2903,1093,3996
02/01/2018,34.00,9,2773,1161,3934
02/01/2018,35.00,10,2726,1212,3938
02/01/2018,36.00,11,2515,1260,3775
02/01/2018,37.00,12,2343,1286,3629
02/01/2018,38.00,13,2420,1286,3706
02/01/2018,39.00,14,2548,1270,3818
02/01/2018,40.00,15,2545,1264,3809
02/01/2018,41.00,16,2706,1219,3925
02/01/2018,42.00,17,2823,1262,4085
02/01/2018,43.00,18,2900,1297,4197
02/01/2018,44.00,19,2672,1218,3890
02/01/2018,45.00,20,2407,1180,3587
02/01/2018,46.00,21,2237,1104,3341
02/01/2018,47.00,22,2422,1145,3567
02/01/2018,48.00,23,2564,1152,3716
03/01/2018,49.00,0,2728,1030,3758
03/01/2018,50.00,1,2860,1082,3942
03/01/2018,51.00,2,2916,1148,4064
03/01/2018,52.00,3,2888,1136,4024
03/01/2018,53.00,4,3040,1202,4242
03/01/2018,54.00,5,3223,1366,4589
03/01/2018,55.00,6,3702,1421,5123
03/01/2018,56.00,7,3964,1519,5483
03/01/2018,57.00,8,3979,1594,5573
03/01/2018,58.00,9,3589,1578,5167
03/01/2018,59.00,10,3176,1477,4653
03/01/2018,60.00,11,2674,1387,4061
03/01/2018,61.00,12,2391,1302,3693
03/01/2018,62.00,13,2211,1205,3416
03/01/2018,63.00,14,1995,1151,3146
03/01/2018,64.00,15,1964,1065,3029
03/01/2018,65.00,16,1864,1103,2967
03/01/2018,66.00,17,1763,1087,2850
03/01/2018,67.00,18,1773,921,2694
03/01/2018,68.00,19,1584,917,2501
03/01/2018,69.00,20,1480,1026,2506
03/01/2018,70.00,21,1497,930,2427
03/01/2018,71.00,22,1602,924,2526
03/01/2018,72.00,23,1724,847,2571
04/01/2018,73.00,0,1760,868,2628
04/01/2018,74.00,1,1738,896,2634
04/01/2018,75.00,2,1813,1089,2902
04/01/2018,76.00,3,1877,1192,3069
04/01/2018,77.00,4,1891,1223,3114
04/01/2018,78.00,5,1928,1207,3135
04/01/2018,79.00,6,1928,1212,3140
04/01/2018,80.00,7,2085,1226,3311
04/01/2018,81.00,8,2531,1352,3883
04/01/2018,82.00,9,2574,1434,4008
04/01/2018,83.00,10,2539,1348,3887
04/01/2018,84.00,11,2614,1348,3962
04/01/2018,85.00,12,2544,1290,3834
04/01/2018,86.00,13,2517,1281,3798
04/01/2018,87.00,14,2479,1252,3731
04/01/2018,88.00,15,2317,1211,3528
04/01/2018,89.00,16,2228,1166,3394
04/01/2018,90.00,17,2200,1100,3300
04/01/2018,91.00,18,2169,1080,3249
04/01/2018,92.00,19,2155,1054,3209
04/01/2018,93.00,20,1749,980,2729
04/01/2018,94.00,21,1407,845,2252
04/01/2018,95.00,22,1138,853,1991
04/01/2018,96.00,23,982,870,1852
05/01/2018,97.00,0,852,826,1678
05/01/2018,98.00,1,848,754,1602
05/01/2018,99.00,2,1068,806,1874
05/01/2018,#####,3,1093,1072,2165
05/01/2018,#####,4,1077,1149,2226
05/01/2018,#####,5,1065,1142,2207
05/01/2018,#####,6,1161,1141,2302
05/01/2018,#####,7,1205,1169,2374
05/01/2018,#####,8,1611,1267,2878
05/01/2018,#####,9,1652,1246,2898
05/01/2018,#####,10,1811,1269,3080
05/01/2018,#####,11,1897,1153,3050
05/01/2018,#####,12,1989,1254,3243
05/01/2018,#####,13,2158,1364,3522
05/01/2018,#####,14,2096,1313,3409
05/01/2018,#####,15,2137,1270,3407
05/01/2018,#####,16,2176,1256,3432
05/01/2018,#####,17,2188,1345,3533
05/01/2018,#####,18,2143,1312,3455
05/01/2018,#####,19,2058,1244,3302
05/01/2018,#####,20,1768,1048,2816
05/01/2018,#####,21,1638,954,2592
05/01/2018,#####,22,1539,933,2472
05/01/2018,#####,23,1279,920,2199
06/01/2018,#####,0,1030,817,1847
06/01/2018,#####,1,1045,777,1822
06/01/2018,#####,2,1013,812,1825
06/01/2018,#####,3,998,787,1785
06/01/2018,#####,4,999,752,1751
06/01/2018,#####,5,1020,751,1771
06/01/2018,#####,6,1121,806,1927
06/01/2018,#####,7,1218,829,2047
06/01/2018,#####,8,1509,915,2424
06/01/2018,#####,9,1995,1114,3109
06/01/2018,#####,10,2093,1119,3212
06/01/2018,#####,11,2223,1101,3324
06/01/2018,#####,12,2199,1105,3304
06/01/2018,#####,13,2172,1142,3314
06/01/2018,#####,14,2133,1149,3282
06/01/2018,#####,15,2078,1101,3179
06/01/2018,#####,16,2235,1087,3322
06/01/2018,#####,17,2649,1175,3824
06/01/2018,#####,18,2622,1150,3772
06/01/2018,#####,19,2364,1139,3503
06/01/2018,#####,20,2034,1151,3185
06/01/2018,#####,21,1816,1108,2924
06/01/2018,#####,22,1654,1111,2765
06/01/2018,#####,23,1492,1067,2559
07/01/2018,#####,0,1207,1035,2242
07/01/2018,#####,1,1058,969,2027
07/01/2018,#####,2,979,968,1947
07/01/2018,#####,3,1108,969,2077
07/01/2018,#####,4,1141,950,2091
07/01/2018,#####,5,1187,867,2054
07/01/2018,#####,6,1235,829,2064
07/01/2018,#####,7,1310,810,2120
07/01/2018,#####,8,1430,857,2287
07/01/2018,#####,9,1658,843,2501
07/01/2018,#####,10,1810,984,2794
07/01/2018,#####,11,1957,1006,2963
07/01/2018,#####,12,2008,1007,3015
07/01/2018,#####,13,1993,1010,3003
07/01/2018,#####,14,1917,1021,2938
07/01/2018,#####,15,1848,997,2845
07/01/2018,#####,16,1946,1005,2951
07/01/2018,#####,17,2214,1009,3223
07/01/2018,#####,18,2408,1003,3411
07/01/2018,#####,19,2349,989,3338
07/01/2018,#####,20,2315,917,3232
07/01/2018,#####,21,2205,916,3121
07/01/2018,#####,22,2076,857,2933
07/01/2018,#####,23,1969,846,2815
08/01/2018,#####,0,1928,851,2779
08/01/2018,#####,1,1749,849,2598
08/01/2018,#####,2,1804,851,2655
08/01/2018,#####,3,1648,848,2496
08/01/2018,#####,4,1501,846,2347
08/01/2018,#####,5,1397,793,2190
08/01/2018,#####,6,1684,808,2492
08/01/2018,#####,7,1960,867,2827
08/01/2018,#####,8,2106,989,3095
08/01/2018,#####,9,2122,1129,3251
08/01/2018,#####,10,2190,1287,3477
08/01/2018,#####,11,2096,1297,3393
08/01/2018,#####,12,2098,1380,3478
08/01/2018,#####,13,1985,1323,3308
08/01/2018,#####,14,1764,1289,3053
08/01/2018,#####,15,1604,1290,2894
08/01/2018,#####,16,1531,1347,2878
08/01/2018,#####,17,1884,1403,3287
08/01/2018,#####,18,2357,1378,3735
08/01/2018,#####,19,2262,1388,3650
08/01/2018,#####,20,2259,1409,3668
08/01/2018,#####,21,2259,1449,3708
08/01/2018,#####,22,2483,1445,3928
08/01/2018,#####,23,2436,1428,3864
09/01/2018,#####,0,2440,1390,3830
09/01/2018,#####,1,2576,1415,3991
09/01/2018,#####,2,2643,1383,4026
09/01/2018,#####,3,2686,1394,4080
09/01/2018,#####,4,2839,1387,4226
09/01/2018,#####,5,3093,1429,4522
09/01/2018,#####,6,3644,1450,5094
09/01/2018,#####,7,4037,1457,5494
09/01/2018,#####,8,3955,1531,5486
09/01/2018,#####,9,3477,1626,5103
09/01/2018,#####,10,3573,1827,5400
09/01/2018,#####,11,3530,1870,5400
09/01/2018,#####,12,3792,1863,5655
09/01/2018,#####,13,3974,1834,5808
09/01/2018,#####,14,3989,1801,5790
09/01/2018,#####,15,4020,1783,5803
09/01/2018,#####,16,4117,1759,5876
09/01/2018,#####,17,4168,1741,5909
09/01/2018,#####,18,4240,1720,5960
09/01/2018,#####,19,3907,1683,5590
09/01/2018,#####,20,3576,1658,5234
09/01/2018,#####,21,3801,1559,5360
09/01/2018,#####,22,3286,1468,4754
09/01/2018,#####,23,3031,1405,4436
10/01/2018,#####,0,2805,1362,4167
10/01/2018,#####,1,2797,1269,4066
10/01/2018,#####,2,2665,1145,3810
10/01/2018,#####,3,2494,1098,3592
10/01/2018,#####,4,2374,1027,3401
10/01/2018,#####,5,2409,1106,3515
10/01/2018,#####,6,2843,1160,4003
10/01/2018,#####,7,3265,1328,4593
10/01/2018,#####,8,3323,1580,4903
10/01/2018,#####,9,3187,1459,4646
10/01/2018,#####,10,2985,1348,4333
10/01/2018,#####,11,2972,1383,4355
10/01/2018,#####,12,2904,1320,4224
10/01/2018,#####,13,2872,1381,4253
10/01/2018,#####,14,2803,1423,4226
10/01/2018,#####,15,2869,1450,4319
10/01/2018,#####,16,2885,1460,4345
10/01/2018,#####,17,2993,1548,4541
10/01/2018,#####,18,2975,1415,4390
10/01/2018,#####,19,2768,1301,4069
10/01/2018,#####,20,2450,1292,3742
10/01/2018,#####,21,2239,1215,3454
10/01/2018,#####,22,1869,1103,2972
10/01/2018,#####,23,1592,1070,2662
11/01/2018,#####,0,1504,980,2484
11/01/2018,#####,1,1514,969,2483
11/01/2018,#####,2,1480,975,2455
11/01/2018,#####,3,1480,963,2443
11/01/2018,#####,4,1447,969,2416
11/01/2018,#####,5,1709,1078,2787
11/01/2018,#####,6,2224,1188,3412
11/01/2018,#####,7,2568,1411,3979
11/01/2018,#####,8,2671,1362,4033
11/01/2018,#####,9,2612,1338,3950
11/01/2018,#####,10,2671,1440,4111
11/01/2018,#####,11,2695,1598,4293
11/01/2018,#####,12,2748,1743,4491
11/01/2018,#####,13,2720,1876,4596
11/01/2018,#####,14,2826,1674,4500
11/01/2018,#####,15,2910,1568,4478
11/01/2018,#####,16,3023,1598,4621
11/01/2018,#####,17,2970,1641,4611
11/01/2018,#####,18,2972,1612,4584
11/01/2018,#####,19,2689,1544,4233
11/01/2018,#####,20,2316,1375,3691
11/01/2018,#####,21,2184,1287,3471
11/01/2018,#####,22,1850,1323,3173
11/01/2018,#####,23,1601,1245,2846
12/01/2018,#####,0,1828,1269,3097
12/01/2018,#####,1,1739,1197,2936
12/01/2018,#####,2,1782,1203,2985
12/01/2018,#####,3,1768,1237,3005
12/01/2018,#####,4,1802,1275,3077
12/01/2018,#####,5,2079,1311,3390
12/01/2018,#####,6,2592,1352,3944
12/01/2018,#####,7,3399,1569,4968
12/01/2018,#####,8,3610,1807,5417
12/01/2018,#####,9,3594,1682,5276
12/01/2018,#####,10,3503,1695,5198
12/01/2018,#####,11,3655,1947,5602
12/01/2018,#####,12,3517,1715,5232
12/01/2018,#####,13,3549,1541,5090
12/01/2018,#####,14,3520,1462,4982
12/01/2018,#####,15,3414,1440,4854
12/01/2018,#####,16,3589,1509,5098
12/01/2018,#####,17,3684,1541,5225
12/01/2018,#####,18,3509,1505,5014
12/01/2018,#####,19,3032,1576,4608
12/01/2018,#####,20,2777,1388,4165
12/01/2018,#####,21,2619,1341,3960
12/01/2018,#####,22,2480,1317,3797
12/01/2018,#####,23,2348,1287,3635
13/01/2018,#####,0,2327,1248,3575
13/01/2018,#####,1,2250,1241,3491
13/01/2018,#####,2,2270,1238,3508
13/01/2018,#####,3,2275,1272,3547
13/01/2018,#####,4,2315,1274,3589
13/01/2018,#####,5,2388,1319,3707
13/01/2018,#####,6,2426,1361,3787
13/01/2018,#####,7,2548,1358,3906
13/01/2018,#####,8,2770,1358,4128
13/01/2018,#####,9,2900,1374,4274
13/01/2018,#####,10,3202,1405,4607
13/01/2018,#####,11,3478,1420,4898
13/01/2018,#####,12,3420,1394,4814
13/01/2018,#####,13,3392,1337,4729
13/01/2018,#####,14,3287,1370,4657
13/01/2018,#####,15,3083,1409,4492
13/01/2018,#####,16,3277,1428,4705
13/01/2018,#####,17,3363,1434,4797
13/01/2018,#####,18,3483,1470,4953
13/01/2018,#####,19,3355,1458,4813
13/01/2018,#####,20,3222,1475,4697
13/01/2018,#####,21,3156,1469,4625
13/01/2018,#####,22,3160,1403,4563
13/01/2018,#####,23,3119,1318,4437
14/01/2018,#####,0,2637,1331,3968
14/01/2018,#####,1,2384,1317,3701
14/01/2018,#####,2,2276,1309,3585
14/01/2018,#####,3,2126,1314,3440
14/01/2018,#####,4,2043,1350,3393
14/01/2018,#####,5,2140,1365,3505
14/01/2018,#####,6,2414,1400,3814
14/01/2018,#####,7,2586,1401,3987
14/01/2018,#####,8,2660,1419,4079
14/01/2018,#####,9,2810,1456,4266
14/01/2018,#####,10,2917,1479,4396
14/01/2018,#####,11,3027,1476,4503
14/01/2018,#####,12,2964,1383,4347
14/01/2018,#####,13,3007,1351,4358
14/01/2018,#####,14,2931,1330,4261
14/01/2018,#####,15,2806,1385,4191
14/01/2018,#####,16,3112,1450,4562
14/01/2018,#####,17,3586,1444,5030
14/01/2018,#####,18,3912,1522,5434
14/01/2018,#####,19,3941,1520,5461
14/01/2018,#####,20,4054,1529,5583
14/01/2018,#####,21,4103,1529,5632
14/01/2018,#####,22,4096,1540,5636
14/01/2018,#####,23,3898,1550,5448
15/01/2018,#####,0,3608,1569,5177
15/01/2018,#####,1,3529,1561,5090
15/01/2018,#####,2,3484,1602,5086
15/01/2018,#####,3,3625,1592,5217
15/01/2018,#####,4,3685,1598,5283
15/01/2018,#####,5,3881,1616,5497
15/01/2018,#####,6,4124,1653,5777
15/01/2018,#####,7,3778,1668,5446
15/01/2018,#####,8,3780,1692,5472
15/01/2018,#####,9,3751,1705,5456
15/01/2018,#####,10,3897,1739,5636
15/01/2018,#####,11,4275,1773,6048
15/01/2018,#####,12,4531,1768,6299
15/01/2018,#####,13,4667,1737,6404
15/01/2018,#####,14,4766,1731,6497
15/01/2018,#####,15,4630,1740,6370
15/01/2018,#####,16,4718,1737,6455
15/01/2018,#####,17,4610,1743,6353
15/01/2018,#####,18,4682,1756,6438
15/01/2018,#####,19,4436,1771,6207
15/01/2018,#####,20,4371,1771,6142
15/01/2018,#####,21,4184,1732,5916
15/01/2018,#####,22,4048,1721,5769
15/01/2018,#####,23,3456,1693,5149
16/01/2018,#####,0,3051,1677,4728
16/01/2018,#####,1,2791,1642,4433
16/01/2018,#####,2,3067,1668,4735
16/01/2018,#####,3,2930,1662,4592
16/01/2018,#####,4,2776,1622,4398
16/01/2018,#####,5,2635,1525,4160
16/01/2018,#####,6,2976,1501,4477
16/01/2018,#####,7,2945,1496,4441
16/01/2018,#####,8,2748,1597,4345
16/01/2018,#####,9,2413,1618,4031
16/01/2018,#####,10,2424,1546,3970
16/01/2018,#####,11,2565,1581,4146
16/01/2018,#####,12,2594,1522,4116
16/01/2018,#####,13,2069,1522,3591
16/01/2018,#####,14,2079,1533,3612
16/01/2018,#####,15,1982,1496,3478
16/01/2018,#####,16,2353,1473,3826
16/01/2018,#####,17,2310,1536,3846
16/01/2018,#####,18,2645,1585,4230
16/01/2018,#####,19,2638,1516,4154
16/01/2018,#####,20,2512,1454,3966
16/01/2018,#####,21,2385,1443,3828
16/01/2018,#####,22,2126,1495,3621
16/01/2018,#####,23,1783,1475,3258
17/01/2018,#####,0,1692,1471,3163
17/01/2018,#####,1,1748,1490,3238
17/01/2018,#####,2,1515,1462,2977
17/01/2018,#####,3,1406,1414,2820
17/01/2018,#####,4,1496,1436,2932
17/01/2018,#####,5,1503,1430,2933
17/01/2018,#####,6,1545,1332,2877
17/01/2018,#####,7,2183,1335,3518
17/01/2018,#####,8,2311,1469,3780
17/01/2018,#####,9,2254,1389,3643
17/01/2018,#####,10,2463,1424,3887
17/01/2018,#####,11,2595,1512,4107
17/01/2018,#####,12,2535,1406,3941
17/01/2018,#####,13,2273,1442,3715
17/01/2018,#####,14,2479,1459,3938
17/01/2018,#####,15,2340,1470,3810
17/01/2018,#####,16,2189,1555,3744
17/01/2018,#####,17,2367,1583,3950
17/01/2018,#####,18,2264,1619,3883
17/01/2018,#####,19,2151,1530,3681
17/01/2018,#####,20,1798,1482,3280
17/01/2018,#####,21,1737,1502,3239
17/01/2018,#####,22,1823,1475,3298
17/01/2018,#####,23,1775,1503,3278
18/01/2018,#####,0,1625,1407,3032
18/01/2018,#####,1,1625,1464,3089
18/01/2018,#####,2,1635,1529,3164
18/01/2018,#####,3,1641,1550,3191
18/01/2018,#####,4,1626,1499,3125
18/01/2018,#####,5,1588,1533,3121
18/01/2018,#####,6,1719,1504,3223
18/01/2018,#####,7,2376,1487,3863
18/01/2018,#####,8,2410,1395,3805
18/01/2018,#####,9,2301,1385,3686
18/01/2018,#####,10,2095,1459,3554
18/01/2018,#####,11,2044,1446,3490
18/01/2018,#####,12,1920,1386,3306
18/01/2018,#####,13,1879,1497,3376
18/01/2018,#####,14,1928,1563,3491
18/01/2018,#####,15,1884,1589,3473
18/01/2018,#####,16,1995,1483,3478
18/01/2018,#####,17,2138,1511,3649
18/01/2018,#####,18,2062,1278,3340
18/01/2018,#####,19,2054,1218,3272
18/01/2018,#####,20,1919,1128,3047
18/01/2018,#####,21,1702,1053,2755
18/01/2018,#####,22,1604,1054,2658
18/01/2018,#####,23,1271,996,2267
19/01/2018,#####,0,1385,1024,2409
19/01/2018,#####,1,1205,984,2189
19/01/2018,#####,2,1098,962,2060
19/01/2018,#####,3,1095,942,2037
19/01/2018,#####,4,1160,953,2113
19/01/2018,#####,5,1332,1002,2334
19/01/2018,#####,6,1967,1086,3053
19/01/2018,#####,7,2240,1133,3373
19/01/2018,#####,8,2303,1175,3478
19/01/2018,#####,9,2334,1263,3597
19/01/2018,#####,10,2392,1280,3672
19/01/2018,#####,11,2406,1303,3709
19/01/2018,#####,12,2432,1264,3696
19/01/2018,#####,13,2554,1242,3796
19/01/2018,#####,14,2441,1236,3677
19/01/2018,#####,15,2346,1317,3663
19/01/2018,#####,16,2335,1422,3757
19/01/2018,#####,17,2493,1423,3916
19/01/2018,#####,18,2606,1357,3963
19/01/2018,#####,19,2478,1376,3854
19/01/2018,#####,20,2305,1333,3638
19/01/2018,#####,21,2064,1245,3309
19/01/2018,#####,22,1772,1240,3012
19/01/2018,#####,23,1638,1245,2883
20/01/2018,#####,0,1441,1210,2651
20/01/2018,#####,1,1487,1106,2593
20/01/2018,#####,2,1556,1112,2668
20/01/2018,#####,3,1570,1096,2666
20/01/2018,#####,4,1529,1106,2635
20/01/2018,#####,5,1631,1067,2698
20/01/2018,#####,6,1807,1098,2905
20/01/2018,#####,7,1858,1084,2942
20/01/2018,#####,8,2224,1080,3304
20/01/2018,#####,9,2500,1173,3673
20/01/2018,#####,10,2693,1276,3969
20/01/2018,#####,11,2637,1280,3917
20/01/2018,#####,12,2742,1263,4005
20/01/2018,#####,13,2622,1254,3876
20/01/2018,#####,14,2572,1211,3783
20/01/2018,#####,15,2448,1172,3620
20/01/2018,#####,16,2451,1133,3584
20/01/2018,#####,17,2552,1203,3755
20/01/2018,#####,18,2624,1184,3808
20/01/2018,#####,19,2601,1190,3791
20/01/2018,#####,20,2287,1111,3398
20/01/2018,#####,21,1987,1041,3028
20/01/2018,#####,22,1927,1041,2968
20/01/2018,#####,23,1636,1010,2646
21/01/2018,#####,0,1323,943,2266
21/01/2018,#####,1,1321,949,2270
21/01/2018,#####,2,1345,919,2264
21/01/2018,#####,3,1297,888,2185
21/01/2018,#####,4,1286,895,2181
21/01/2018,#####,5,1232,894,2126
21/01/2018,#####,6,1306,893,2199
21/01/2018,#####,7,1368,925,2293
21/01/2018,#####,8,1480,970,2450
21/01/2018,#####,9,1786,1098,2884
21/01/2018,#####,10,1959,1140,3099
21/01/2018,#####,11,2058,1170,3228
21/01/2018,#####,12,2056,1176,3232
21/01/2018,#####,13,1998,1100,3098
21/01/2018,#####,14,1950,1085,3035
21/01/2018,#####,15,1970,1085,3055
21/01/2018,#####,16,2055,1144,3199
21/01/2018,#####,17,2336,1193,3529
21/01/2018,#####,18,2396,1184,3580
21/01/2018,#####,19,2477,1132,3609
21/01/2018,#####,20,2246,1062,3308
21/01/2018,#####,21,1852,1017,2869
21/01/2018,#####,22,1957,1009,2966
21/01/2018,#####,23,1938,988,2926
22/01/2018,#####,0,1943,1012,2955
22/01/2018,#####,1,2058,1048,3106
22/01/2018,#####,2,2035,1104,3139
22/01/2018,#####,3,2118,1150,3268
22/01/2018,#####,4,2224,1150,3374
22/01/2018,#####,5,2333,1250,3583
22/01/2018,#####,6,2938,1363,4301
22/01/2018,#####,7,3193,1625,4818
22/01/2018,#####,8,3550,1769,5319
22/01/2018,#####,9,3615,1770,5385
22/01/2018,#####,10,3543,1764,5307
22/01/2018,#####,11,3366,1752,5118
22/01/2018,#####,12,3472,1720,5192
22/01/2018,#####,13,3453,1672,5125
22/01/2018,#####,14,3226,1684,4910
22/01/2018,#####,15,3161,1595,4756
22/01/2018,#####,16,3147,1756,4903
22/01/2018,#####,17,3090,1809,4899
22/01/2018,#####,18,2968,1777,4745
22/01/2018,#####,19,2868,1737,4605
22/01/2018,#####,20,2874,1671,4545
22/01/2018,#####,21,2690,1384,4074
22/01/2018,#####,22,2245,1198,3443
22/01/2018,#####,23,2008,1086,3094
23/01/2018,#####,0,1662,953,2615
23/01/2018,#####,1,1478,923,2401
23/01/2018,#####,2,1453,909,2362
23/01/2018,#####,3,1544,871,2415
23/01/2018,#####,4,1695,887,2582
23/01/2018,#####,5,2135,956,3091
23/01/2018,#####,6,2734,1161,3895
23/01/2018,#####,7,3067,1348,4415
23/01/2018,#####,8,3352,1527,4879
23/01/2018,#####,9,3270,1487,4757
23/01/2018,#####,10,3527,1519,5046
23/01/2018,#####,11,3402,1484,4886
23/01/2018,#####,12,3443,1565,5008
23/01/2018,#####,13,3526,1523,5049
23/01/2018,#####,14,3763,1597,5360
23/01/2018,#####,15,3573,1557,5130
23/01/2018,#####,16,3661,1637,5298
23/01/2018,#####,17,4067,1689,5756
23/01/2018,#####,18,4151,1678,5829
23/01/2018,#####,19,4510,1682,6192
23/01/2018,#####,20,4530,1740,6270
23/01/2018,#####,21,4504,1768,6272
23/01/2018,#####,22,4173,1761,5934
23/01/2018,#####,23,3882,1754,5636
24/01/2018,#####,0,3947,1726,5673
24/01/2018,#####,1,3568,1686,5254
24/01/2018,#####,2,3119,1675,4794
24/01/2018,#####,3,2833,1628,4461
24/01/2018,#####,4,3062,1627,4689
24/01/2018,#####,5,3247,1560,4807
24/01/2018,#####,6,3326,1511,4837
24/01/2018,#####,7,3712,1429,5141
24/01/2018,#####,8,3897,1468,5365
24/01/2018,#####,9,3891,1514,5405
24/01/2018,#####,10,4251,1579,5830
24/01/2018,#####,11,4447,1645,6092
24/01/2018,#####,12,4529,1723,6252
24/01/2018,#####,13,4898,1782,6680
24/01/2018,#####,14,4687,1788,6475
24/01/2018,#####,15,4747,1791,6538
24/01/2018,#####,16,4828,1781,6609
24/01/2018,#####,17,4484,1755,6239
24/01/2018,#####,18,4179,1765,5944
24/01/2018,#####,19,4010,1768,5778
24/01/2018,#####,20,3848,1696,5544
24/01/2018,#####,21,3864,1582,5446
24/01/2018,#####,22,3865,1415,5280
24/01/2018,#####,23,4054,1247,5301
25/01/2018,#####,0,3904,1351,5255
25/01/2018,#####,1,3850,1257,5107
25/01/2018,#####,2,3820,1228,5048
25/01/2018,#####,3,3607,1270,4877
25/01/2018,#####,4,3528,1220,4748
25/01/2018,#####,5,3674,1380,5054
25/01/2018,#####,6,3874,1510,5384
25/01/2018,#####,7,4251,1553,5804
25/01/2018,#####,8,3708,1528,5236
25/01/2018,#####,9,2951,1472,4423
25/01/2018,#####,10,3164,1493,4657
25/01/2018,#####,11,3454,1571,5025
25/01/2018,#####,12,3599,1529,5128
25/01/2018,#####,13,3643,1560,5203
25/01/2018,#####,14,3266,1424,4690
25/01/2018,#####,15,2993,1423,4416
25/01/2018,#####,16,2668,1350,4018
25/01/2018,#####,17,3137,1437,4574
25/01/2018,#####,18,2991,1440,4431
25/01/2018,#####,19,2829,1371,4200
25/01/2018,#####,20,2552,1368,3920
25/01/2018,#####,21,2322,1310,3632
25/01/2018,#####,22,2132,1260,3392
25/01/2018,#####,23,1952,1188,3140
26/01/2018,#####,0,1814,1184,2998
26/01/2018,#####,1,1754,1174,2928
26/01/2018,#####,2,1621,1129,2750
26/01/2018,#####,3,1588,1108,2696
26/01/2018,#####,4,1587,1059,2646
26/01/2018,#####,5,1864,1063,2927
26/01/2018,#####,6,2172,1100,3272
26/01/2018,#####,7,1873,1193,3066
26/01/2018,#####,8,2022,1273,3295
26/01/2018,#####,9,1966,1397,3363
26/01/2018,#####,10,1975,1378,3353
26/01/2018,#####,11,2032,1265,3297
26/01/2018,#####,12,1852,1372,3224
26/01/2018,#####,13,1835,1370,3205
26/01/2018,#####,14,1746,1367,3113
26/01/2018,#####,15,1824,1369,3193
26/01/2018,#####,16,1884,1373,3257
26/01/2018,#####,17,2611,1395,4006
26/01/2018,#####,18,2660,1516,4176
26/01/2018,#####,19,2417,1323,3740
26/01/2018,#####,20,2101,1147,3248
26/01/2018,#####,21,1778,1041,2819
26/01/2018,#####,22,1618,1037,2655
26/01/2018,#####,23,1619,1056,2675
27/01/2018,#####,0,1512,1117,2629
27/01/2018,#####,1,1455,1162,2617
27/01/2018,#####,2,1430,1157,2587
27/01/2018,#####,3,1452,1146,2598
27/01/2018,#####,4,1436,1189,2625
27/01/2018,#####,5,1334,1150,2484
27/01/2018,#####,6,1340,1145,2485
27/01/2018,#####,7,1576,1126,2702
27/01/2018,#####,8,1984,1196,3180
27/01/2018,#####,9,2257,1335,3592
27/01/2018,#####,10,2313,1370,3683
27/01/2018,#####,11,2337,1365,3702
27/01/2018,#####,12,2472,1345,3817
27/01/2018,#####,13,2803,1418,4221
27/01/2018,#####,14,3153,1432,4585
27/01/2018,#####,15,3330,1515,4845
27/01/2018,#####,16,3844,1531,5375
27/01/2018,#####,17,4019,1607,5626
27/01/2018,#####,18,4330,1576,5906
27/01/2018,#####,19,4327,1689,6016
27/01/2018,#####,20,4584,1730,6314
27/01/2018,#####,21,4209,1747,5956
27/01/2018,#####,22,4121,1788,5909
27/01/2018,#####,23,3684,1642,5326
28/01/2018,#####,0,2944,1548,4492
28/01/2018,#####,1,2617,1340,3957
28/01/2018,#####,2,2473,1296,3769
28/01/2018,#####,3,2606,1274,3880
28/01/2018,#####,4,2550,1412,3962
28/01/2018,#####,5,3061,1463,4524
28/01/2018,#####,6,2915,1489,4404
28/01/2018,#####,7,3432,1430,4862
28/01/2018,#####,8,3550,1535,5085
28/01/2018,#####,9,3539,1651,5190
28/01/2018,#####,10,3652,1669,5321
28/01/2018,#####,11,3644,1683,5327
28/01/2018,#####,12,3604,1685,5289
28/01/2018,#####,13,3667,1690,5357
28/01/2018,#####,14,3661,1664,5325
28/01/2018,#####,15,3388,1646,5034
28/01/2018,#####,16,3461,1649,5110
28/01/2018,#####,17,3647,1659,5306
28/01/2018,#####,18,3423,1558,4981
28/01/2018,#####,19,3100,1353,4453
28/01/2018,#####,20,2959,1307,4266
28/01/2018,#####,21,2792,1292,4084
28/01/2018,#####,22,2558,1263,3821
28/01/2018,#####,23,2439,1310,3749
29/01/2018,#####,0,2286,1327,3613
29/01/2018,#####,1,2362,1366,3728
29/01/2018,#####,2,2446,1376,3822
29/01/2018,#####,3,2603,1434,4037
29/01/2018,#####,4,2813,1507,4320
29/01/2018,#####,5,3024,1592,4616
29/01/2018,#####,6,3523,1722,5245
29/01/2018,#####,7,4269,1857,6126
29/01/2018,#####,8,4285,1882,6167
29/01/2018,#####,9,4255,1978,6233
29/01/2018,#####,10,4376,2001,6377
29/01/2018,#####,11,4403,1982,6385
29/01/2018,#####,12,4259,1942,6201
29/01/2018,#####,13,4327,1889,6216
29/01/2018,#####,14,4601,1850,6451
29/01/2018,#####,15,4499,1843,6342
29/01/2018,#####,16,4136,1809,5945
29/01/2018,#####,17,4159,1824,5983
29/01/2018,#####,18,4096,1817,5913
29/01/2018,#####,19,4086,1760,5846
29/01/2018,#####,20,4464,1728,6192
29/01/2018,#####,21,4006,1663,5669
29/01/2018,#####,22,3970,1582,5552
29/01/2018,#####,23,3819,1609,5428
30/01/2018,#####,0,3994,1641,5635
30/01/2018,#####,1,3972,1661,5633
30/01/2018,#####,2,3981,1756,5737
30/01/2018,#####,3,3865,1746,5611
30/01/2018,#####,4,3992,1735,5727
30/01/2018,#####,5,3808,1748,5556
30/01/2018,#####,6,4104,1757,5861
30/01/2018,#####,7,4197,1827,6024
30/01/2018,#####,8,3927,1834,5761
30/01/2018,#####,9,3747,1895,5642
30/01/2018,#####,10,3771,1863,5634
30/01/2018,#####,11,3583,1865,5448
30/01/2018,#####,12,3419,1829,5248
30/01/2018,#####,13,3315,1784,5099
30/01/2018,#####,14,3096,1720,4816
30/01/2018,#####,15,2996,1669,4665
30/01/2018,#####,16,2838,1652,4490
30/01/2018,#####,17,3410,1714,5124
30/01/2018,#####,18,3275,1631,4906
30/01/2018,#####,19,3536,1462,4998
30/01/2018,#####,20,3260,1370,4630
30/01/2018,#####,21,3051,1416,4467
30/01/2018,#####,22,2922,1412,4334
30/01/2018,#####,23,3199,1461,4660
31/01/2018,#####,0,3156,1485,4641
31/01/2018,#####,1,3328,1395,4723
31/01/2018,#####,2,3217,1431,4648
31/01/2018,#####,3,3366,1460,4826
31/01/2018,#####,4,3434,1487,4921
31/01/2018,#####,5,3409,1540,4949
31/01/2018,#####,6,3719,1562,5281
31/01/2018,#####,7,4030,1599,5629
31/01/2018,#####,8,4182,1659,5841
31/01/2018,#####,9,3989,1753,5742
31/01/2018,#####,10,3857,1803,5660
31/01/2018,#####,11,4245,1830,6075
31/01/2018,#####,12,4046,1802,5848
31/01/2018,#####,13,3741,1809,5550
31/01/2018,#####,14,3886,1786,5672
31/01/2018,#####,15,3534,1627,5161
31/01/2018,#####,16,3536,1535,5071
31/01/2018,#####,17,4009,1721,5730
31/01/2018,#####,18,3998,1637,5635
31/01/2018,#####,19,3885,1393,5278
31/01/2018,#####,20,3542,1506,5048
31/01/2018,#####,21,3305,1528,4833
31/01/2018,#####,22,3429,1522,4951
31/01/2018,#####,23,3329,1558,4887
01/02/2018,#####,0,3430,1603,5033
01/02/2018,#####,1,3625,1619,5244
01/02/2018,#####,2,3697,1610,5307
01/02/2018,#####,3,3521,1521,5042
01/02/2018,#####,4,3787,1568,5355
01/02/2018,#####,5,3887,1653,5540
01/02/2018,#####,6,3730,1661,5391
01/02/2018,#####,7,3499,1726,5225
01/02/2018,#####,8,3401,1737,5138
01/02/2018,#####,9,3517,1773,5290
01/02/2018,#####,10,3748,1756,5504
01/02/2018,#####,11,4013,1771,5784
01/02/2018,#####,12,4159,1746,5905
01/02/2018,#####,13,3728,1719,5447
01/02/2018,#####,14,3658,1722,5380
01/02/2018,#####,15,3561,1746,5307
01/02/2018,#####,16,3691,1754,5445
01/02/2018,#####,17,3644,1755,5399
01/02/2018,#####,18,3257,1842,5099
01/02/2018,#####,19,2938,1721,4659
01/02/2018,#####,20,2431,1681,4112
01/02/2018,#####,21,2246,1713,3959
01/02/2018,#####,22,2088,1671,3759
01/02/2018,#####,23,2711,1739,4450
02/02/2018,#####,0,2528,1710,4238
02/02/2018,#####,1,2682,1704,4386
02/02/2018,#####,2,2749,1716,4465
02/02/2018,#####,3,2736,1682,4418
02/02/2018,#####,4,2808,1634,4442
02/02/2018,#####,5,2976,1579,4555
02/02/2018,#####,6,3433,1571,5004
02/02/2018,#####,7,3686,1547,5233
02/02/2018,#####,8,3998,1457,5455
02/02/2018,#####,9,4030,1455,5485
02/02/2018,#####,10,4069,1383,5452
02/02/2018,#####,11,3937,1291,5228
02/02/2018,#####,12,3817,1209,5026
02/02/2018,#####,13,3632,1138,4770
02/02/2018,#####,14,3474,1163,4637
02/02/2018,#####,15,3398,1221,4619
02/02/2018,#####,16,3435,1236,4671
02/02/2018,#####,17,3618,1267,4885
02/02/2018,#####,18,3509,1271,4780
02/02/2018,#####,19,3167,1169,4336
02/02/2018,#####,20,2815,1134,3949
02/02/2018,#####,21,2507,1146,3653
02/02/2018,#####,22,2360,1179,3539
02/02/2018,#####,23,2139,1235,3374
03/02/2018,#####,0,2110,1265,3375
03/02/2018,#####,1,1867,1237,3104
03/02/2018,#####,2,1780,1196,2976
03/02/2018,#####,3,1726,1221,2947
03/02/2018,#####,4,1789,1186,2975
03/02/2018,#####,5,2016,1164,3180
03/02/2018,#####,6,1998,1166,3164
03/02/2018,#####,7,2106,1123,3229
03/02/2018,#####,8,2255,1142,3397
03/02/2018,#####,9,2537,1212,3749
03/02/2018,#####,10,2590,1344,3934
03/02/2018,#####,11,2634,1321,3955
03/02/2018,#####,12,2734,1361,4095
03/02/2018,#####,13,2832,1268,4100
03/02/2018,#####,14,2956,1166,4122
03/02/2018,#####,15,2995,1185,4180
03/02/2018,#####,16,3121,1266,4387
03/02/2018,#####,17,3298,1271,4569
03/02/2018,#####,18,3492,1239,4731
03/02/2018,#####,19,3737,1087,4824
03/02/2018,#####,20,3835,1045,4880
03/02/2018,#####,21,3937,1044,4981
03/02/2018,#####,22,4053,1037,5090
03/02/2018,#####,23,4152,1017,5169
04/02/2018,#####,0,4138,1035,5173
04/02/2018,#####,1,4046,1032,5078
04/02/2018,#####,2,3969,1036,5005
04/02/2018,#####,3,3984,1080,5064
04/02/2018,#####,4,3847,1169,5016
04/02/2018,#####,5,3785,1216,5001
04/02/2018,#####,6,3723,1237,4960
04/02/2018,#####,7,3910,1360,5270
04/02/2018,#####,8,4007,1558,5565
04/02/2018,#####,9,4029,1731,5760
04/02/2018,#####,10,3938,1756,5694
04/02/2018,#####,11,3585,1732,5317
04/02/2018,#####,12,3592,1680,5272
04/02/2018,#####,13,3362,1713,5075
04/02/2018,#####,14,3291,1616,4907
04/02/2018,#####,15,3301,1563,4864
04/02/2018,#####,16,3323,1612,4935
04/02/2018,#####,17,3383,1583,4966
04/02/2018,#####,18,3334,1634,4968
04/02/2018,#####,19,3192,1635,4827
04/02/2018,#####,20,2977,1575,4552
04/02/2018,#####,21,2873,1462,4335
04/02/2018,#####,22,2777,1434,4211
04/02/2018,#####,23,2669,1334,4003
05/02/2018,#####,0,2151,1236,3387
05/02/2018,#####,1,1942,1366,3308
05/02/2018,#####,2,1794,1350,3144
05/02/2018,#####,3,1664,1305,2969
05/02/2018,#####,4,1785,1289,3074
05/02/2018,#####,5,1856,1289,3145
05/02/2018,#####,6,2181,1333,3514
05/02/2018,#####,7,2688,1481,4169
05/02/2018,#####,8,2733,1532,4265
05/02/2018,#####,9,2624,1498,4122
05/02/2018,#####,10,2716,1538,4254
05/02/2018,#####,11,2708,1506,4214
05/02/2018,#####,12,2649,1468,4117
05/02/2018,#####,13,2696,1482,4178
05/02/2018,#####,14,2606,1379,3985
05/02/2018,#####,15,2552,1425,3977
05/02/2018,#####,16,2500,1402,3902
05/02/2018,#####,17,2458,1408,3866
05/02/2018,#####,18,2495,1438,3933
05/02/2018,#####,19,2529,1403,3932
05/02/2018,#####,20,2412,1331,3743
05/02/2018,#####,21,2319,1321,3640
05/02/2018,#####,22,2196,1290,3486
05/02/2018,#####,23,1977,1241,3218
06/02/2018,#####,0,1964,1243,3207
06/02/2018,#####,1,1801,1193,2994
06/02/2018,#####,2,1778,1185,2963
06/02/2018,#####,3,1824,1192,3016
06/02/2018,#####,4,1841,1173,3014
06/02/2018,#####,5,2179,1206,3385
06/02/2018,#####,6,2409,1269,3678
06/02/2018,#####,7,2706,1346,4052
06/02/2018,#####,8,2740,1439,4179
06/02/2018,#####,9,2697,1474,4171
06/02/2018,#####,10,2767,1501,4268
06/02/2018,#####,11,2758,1538,4296
06/02/2018,#####,12,2780,1573,4353
06/02/2018,#####,13,2789,1545,4334
06/02/2018,#####,14,2636,1551,4187
06/02/2018,#####,15,2663,1498,4161
06/02/2018,#####,16,2691,1489,4180
06/02/2018,#####,17,2758,1472,4230
06/02/2018,#####,18,2783,1580,4363
06/02/2018,#####,19,2745,1656,4401
06/02/2018,#####,20,2619,1512,4131
06/02/2018,#####,21,2487,1322,3809
06/02/2018,#####,22,2246,1218,3464
06/02/2018,#####,23,2240,1196,3436
07/02/2018,#####,0,2401,1062,3463
07/02/2018,#####,1,2429,992,3421
07/02/2018,#####,2,2370,997,3367
07/02/2018,#####,3,2472,995,3467
07/02/2018,#####,4,2478,992,3470
07/02/2018,#####,5,2545,1140,3685
07/02/2018,#####,6,2962,1347,4309
07/02/2018,#####,7,3244,1521,4765
07/02/2018,#####,8,3243,1504,4747
07/02/2018,#####,9,3316,1503,4819
07/02/2018,#####,10,3420,1621,5041
07/02/2018,#####,11,3473,1685,5158
07/02/2018,#####,12,3473,1662,5135
07/02/2018,#####,13,3312,1670,4982
07/02/2018,#####,14,3330,1639,4969
07/02/2018,#####,15,3345,1602,4947
07/02/2018,#####,16,3380,1543,4923
07/02/2018,#####,17,3787,1631,5418
07/02/2018,#####,18,3797,1557,5354
07/02/2018,#####,19,3700,1527,5227
07/02/2018,#####,20,3460,1534,4994
07/02/2018,#####,21,3075,1336,4411
07/02/2018,#####,22,2680,1177,3857
07/02/2018,#####,23,2458,1064,3522
08/02/2018,#####,0,2244,1105,3349
08/02/2018,#####,1,2425,1158,3583
08/02/2018,#####,2,2424,1121,3545
08/02/2018,#####,3,2467,1095,3562
08/02/2018,#####,4,2586,1110,3696
08/02/2018,#####,5,2815,1148,3963
08/02/2018,#####,6,3082,1218,4300
08/02/2018,#####,7,3436,1418,4854
08/02/2018,#####,8,3410,1472,4882
08/02/2018,#####,9,3304,1415,4719
08/02/2018,#####,10,3408,1424,4832
08/02/2018,#####,11,3482,1450,4932
08/02/2018,#####,12,3578,1465,5043
08/02/2018,#####,13,3623,1451,5074
08/02/2018,#####,14,3795,1403,5198
08/02/2018,#####,15,3546,1353,4899
08/02/2018,#####,16,3246,1422,4668
08/02/2018,#####,17,3062,1429,4491
08/02/2018,#####,18,3834,1583,5417
08/02/2018,#####,19,3690,1596,5286
08/02/2018,#####,20,3685,1513,5198
08/02/2018,#####,21,3560,1335,4895
08/02/2018,#####,22,3655,1281,4936
08/02/2018,#####,23,3691,1277,4968
09/02/2018,#####,0,3545,1235,4780
09/02/2018,#####,1,3444,1212,4656
09/02/2018,#####,2,3467,1190,4657
09/02/2018,#####,3,3495,1189,4684
09/02/2018,#####,4,3439,1177,4616
09/02/2018,#####,5,3542,1203,4745
09/02/2018,#####,6,3875,1280,5155
09/02/2018,#####,7,3799,1462,5261
09/02/2018,#####,8,3844,1552,5396
09/02/2018,#####,9,3880,1633,5513
09/02/2018,#####,10,3921,1622,5543
09/02/2018,#####,11,3884,1678,5562
09/02/2018,#####,12,3782,1686,5468
09/02/2018,#####,13,3609,1687,5296
09/02/2018,#####,14,3482,1597,5079
09/02/2018,#####,15,3346,1586,4932
09/02/2018,#####,16,3124,1599,4723
09/02/2018,#####,17,3628,1675,5303
09/02/2018,#####,18,3617,1702,5319
09/02/2018,#####,19,3502,1718,5220
09/02/2018,#####,20,3328,1592,4920
09/02/2018,#####,21,3167,1461,4628
09/02/2018,#####,22,2857,1301,4158
09/02/2018,#####,23,2616,1273,3889
10/02/2018,#####,0,2449,1160,3609
10/02/2018,#####,1,2481,1161,3642
10/02/2018,#####,2,2438,1137,3575
10/02/2018,#####,3,2312,1108,3420
10/02/2018,#####,4,2202,1103,3305
10/02/2018,#####,5,2365,1110,3475
10/02/2018,#####,6,2590,1106,3696
10/02/2018,#####,7,2611,1126,3737
10/02/2018,#####,8,2792,1143,3935
10/02/2018,#####,9,2924,1291,4215
10/02/2018,#####,10,3044,1373,4417
10/02/2018,#####,11,3145,1401,4546
10/02/2018,#####,12,3027,1328,4355
10/02/2018,#####,13,2973,1274,4247
10/02/2018,#####,14,2967,1263,4230
10/02/2018,#####,15,3005,1261,4266
10/02/2018,#####,16,2993,1243,4236
10/02/2018,#####,17,3153,1295,4448
10/02/2018,#####,18,3249,1246,4495
10/02/2018,#####,19,3236,1226,4462
10/02/2018,#####,20,3366,1144,4510
10/02/2018,#####,21,3594,1028,4622
10/02/2018,#####,22,3546,1013,4559
10/02/2018,#####,23,3351,1044,4395
11/02/2018,#####,0,3320,1114,4434
11/02/2018,#####,1,3519,1154,4673
11/02/2018,#####,2,3512,1161,4673
11/02/2018,#####,3,3194,1226,4420
11/02/2018,#####,4,3185,1333,4518
11/02/2018,#####,5,3384,1389,4773
11/02/2018,#####,6,3187,1555,4742
11/02/2018,#####,7,3327,1605,4932
11/02/2018,#####,8,3688,1677,5365
11/02/2018,#####,9,3854,1717,5571
11/02/2018,#####,10,3854,1725,5579
11/02/2018,#####,11,4222,1735,5957
11/02/2018,#####,12,4297,1725,6022
11/02/2018,#####,13,4238,1689,5927
11/02/2018,#####,14,4228,1694,5922
11/02/2018,#####,15,4284,1690,5974
11/02/2018,#####,16,4319,1703,6022
11/02/2018,#####,17,4376,1774,6150
11/02/2018,#####,18,4809,1760,6569
11/02/2018,#####,19,4865,1753,6618
11/02/2018,#####,20,4682,1737,6419
11/02/2018,#####,21,4192,1692,5884
11/02/2018,#####,22,3926,1686,5612
11/02/2018,#####,23,3997,1682,5679
12/02/2018,#####,0,4251,1664,5915
12/02/2018,#####,1,4284,1649,5933
12/02/2018,#####,2,4129,1640,5769
12/02/2018,#####,3,4179,1627,5806
12/02/2018,#####,4,4187,1615,5802
12/02/2018,#####,5,4357,1617,5974
12/02/2018,#####,6,4299,1711,6010
12/02/2018,#####,7,4718,1757,6475
12/02/2018,#####,8,4461,1774,6235
12/02/2018,#####,9,4525,1821,6346
12/02/2018,#####,10,4590,1833,6423
12/02/2018,#####,11,4627,1793,6420
12/02/2018,#####,12,4691,1820,6511
12/02/2018,#####,13,4497,1759,6256
12/02/2018,#####,14,4513,1740,6253
12/02/2018,#####,15,3935,1657,5592
12/02/2018,#####,16,3673,1644,5317
12/02/2018,#####,17,3471,1669,5140
12/02/2018,#####,18,3292,1652,4944
12/02/2018,#####,19,3021,1682,4703
12/02/2018,#####,20,2775,1631,4406
12/02/2018,#####,21,2647,1534,4181
12/02/2018,#####,22,2756,1509,4265
12/02/2018,#####,23,2302,1471,3773
13/02/2018,#####,0,2503,1593,4096
13/02/2018,#####,1,2363,1571,3934
13/02/2018,#####,2,2254,1501,3755
13/02/2018,#####,3,2031,1416,3447
13/02/2018,#####,4,1951,1334,3285
13/02/2018,#####,5,2257,1286,3543
13/02/2018,#####,6,2183,1322,3505
13/02/2018,#####,7,2432,1386,3818
13/02/2018,#####,8,2730,1498,4228
13/02/2018,#####,9,2625,1525,4150
13/02/2018,#####,10,2820,1514,4334
13/02/2018,#####,11,2904,1472,4376
13/02/2018,#####,12,2769,1402,4171
13/02/2018,#####,13,2780,1353,4133
13/02/2018,#####,14,2705,1383,4088
13/02/2018,#####,15,2661,1352,4013
13/02/2018,#####,16,2799,1362,4161
13/02/2018,#####,17,3056,1413,4469
13/02/2018,#####,18,3136,1460,4596
13/02/2018,#####,19,3074,1365,4439
13/02/2018,#####,20,2900,1278,4178
13/02/2018,#####,21,2894,1269,4163
13/02/2018,#####,22,2862,1234,4096
13/02/2018,#####,23,2723,1169,3892
14/02/2018,#####,0,2439,1139,3578
14/02/2018,#####,1,2475,1107,3582
14/02/2018,#####,2,2368,1099,3467
14/02/2018,#####,3,2289,1101,3390
14/02/2018,#####,4,2220,1119,3339
14/02/2018,#####,5,2353,1121,3474
14/02/2018,#####,6,2639,1233,3872
14/02/2018,#####,7,3045,1344,4389
14/02/2018,#####,8,2958,1350,4308
14/02/2018,#####,9,2902,1389,4291
14/02/2018,#####,10,3036,1405,4441
14/02/2018,#####,11,3117,1426,4543
14/02/2018,#####,12,3402,1470,4872
14/02/2018,#####,13,3658,1433,5091
14/02/2018,#####,14,3863,1414,5277
14/02/2018,#####,15,3745,1407,5152
14/02/2018,#####,16,3502,1414,4916
14/02/2018,#####,17,3733,1410,5143
14/02/2018,#####,18,4357,1540,5897
14/02/2018,#####,19,4396,1523,5919
14/02/2018,#####,20,4417,1533,5950
14/02/2018,#####,21,4218,1575,5793
14/02/2018,#####,22,4252,1537,5789
14/02/2018,#####,23,4299,1647,5946
15/02/2018,#####,0,4270,1622,5892
15/02/2018,#####,1,4229,1612,5841
15/02/2018,#####,2,3883,1597,5480
15/02/2018,#####,3,3887,1611,5498
15/02/2018,#####,4,4010,1638,5648
15/02/2018,#####,5,4169,1730,5899
15/02/2018,#####,6,4462,1752,6214
15/02/2018,#####,7,4709,1738,6447
15/02/2018,#####,8,4525,1771,6296
15/02/2018,#####,9,4686,1853,6539
15/02/2018,#####,10,5019,1915,6934
15/02/2018,#####,11,4579,1916,6495
15/02/2018,#####,12,4272,1899,6171
15/02/2018,#####,13,4307,1780,6087
15/02/2018,#####,14,4266,1752,6018
15/02/2018,#####,15,4110,1738,5848
15/02/2018,#####,16,3812,1717,5529
15/02/2018,#####,17,3663,1740,5403
15/02/2018,#####,18,4070,1713,5783
15/02/2018,#####,19,3728,1669,5397
15/02/2018,#####,20,3319,1536,4855
15/02/2018,#####,21,3039,1473,4512
15/02/2018,#####,22,3056,1411,4467
15/02/2018,#####,23,3065,1362,4427
16/02/2018,#####,0,2525,1265,3790
16/02/2018,#####,1,2463,1272,3735
16/02/2018,#####,2,2501,1240,3741
16/02/2018,#####,3,2728,1391,4119
16/02/2018,#####,4,2758,1408,4166
16/02/2018,#####,5,2719,1375,4094
16/02/2018,#####,6,2842,1528,4370
16/02/2018,#####,7,3139,1721,4860
16/02/2018,#####,8,3379,1762,5141
16/02/2018,#####,9,3414,1730,5144
16/02/2018,#####,10,3676,1816,5492
16/02/2018,#####,11,3901,1897,5798
16/02/2018,#####,12,3727,1872,5599
16/02/2018,#####,13,3723,1834,5557
16/02/2018,#####,14,3114,1827,4941
16/02/2018,#####,15,2896,1844,4740
16/02/2018,#####,16,2507,1810,4317
16/02/2018,#####,17,2617,1907,4524
16/02/2018,#####,18,2834,1916,4750
16/02/2018,#####,19,2493,1815,4308
16/02/2018,#####,20,1736,1700,3436
16/02/2018,#####,21,1660,1575,3235
16/02/2018,#####,22,1533,1543,3076
16/02/2018,#####,23,1732,1508,3240
17/02/2018,#####,0,1598,1414,3012
17/02/2018,#####,1,1721,1419,3140
17/02/2018,#####,2,1633,1352,2985
17/02/2018,#####,3,1486,1274,2760
17/02/2018,#####,4,1564,1203,2767
17/02/2018,#####,5,1563,1179,2742
17/02/2018,#####,6,1555,1135,2690
17/02/2018,#####,7,1735,1157,2892
17/02/2018,#####,8,1850,1224,3074
17/02/2018,#####,9,2073,1379,3452
17/02/2018,#####,10,2066,1485,3551
17/02/2018,#####,11,2099,1454,3553
17/02/2018,#####,12,2031,1434,3465
17/02/2018,#####,13,1962,1394,3356
17/02/2018,#####,14,1983,1379,3362
17/02/2018,#####,15,1963,1336,3299
17/02/2018,#####,16,1952,1283,3235
17/02/2018,#####,17,2158,1431,3589
17/02/2018,#####,18,2240,1463,3703
17/02/2018,#####,19,2077,1392,3469
17/02/2018,#####,20,1937,1286,3223
17/02/2018,#####,21,1892,1191,3083
17/02/2018,#####,22,1871,1124,2995
17/02/2018,#####,23,1885,1095,2980
18/02/2018,#####,0,1907,1055,2962
18/02/2018,#####,1,2018,1052,3070
18/02/2018,#####,2,2174,1087,3261
18/02/2018,#####,3,2137,1082,3219
18/02/2018,#####,4,2161,1080,3241
18/02/2018,#####,5,2207,1091,3298
18/02/2018,#####,6,2161,1125,3286
18/02/2018,#####,7,2220,1107,3327
18/02/2018,#####,8,2472,1209,3681
18/02/2018,#####,9,2676,1326,4002
18/02/2018,#####,10,2865,1419,4284
18/02/2018,#####,11,2908,1452,4360
18/02/2018,#####,12,3041,1471,4512
18/02/2018,#####,13,3148,1464,4612
18/02/2018,#####,14,3091,1415,4506
18/02/2018,#####,15,2971,1385,4356
18/02/2018,#####,16,2942,1357,4299
18/02/2018,#####,17,3069,1477,4546
18/02/2018,#####,18,3050,1482,4532
18/02/2018,#####,19,2922,1474,4396
18/02/2018,#####,20,2732,1345,4077
18/02/2018,#####,21,2570,1355,3925
18/02/2018,#####,22,2278,1400,3678
18/02/2018,#####,23,2117,1309,3426
19/02/2018,#####,0,1978,1289,3267
19/02/2018,#####,1,1913,1254,3167
19/02/2018,#####,2,1773,1228,3001
19/02/2018,#####,3,1766,1216,2982
19/02/2018,#####,4,1891,1203,3094
19/02/2018,#####,5,2057,1237,3294
19/02/2018,#####,6,2516,1387,3903
19/02/2018,#####,7,2721,1558,4279
19/02/2018,#####,8,2590,1601,4191
19/02/2018,#####,9,2577,1608,4185
19/02/2018,#####,10,2604,1628,4232
19/02/2018,#####,11,2503,1623,4126
19/02/2018,#####,12,2642,1627,4269
19/02/2018,#####,13,2587,1589,4176
19/02/2018,#####,14,2536,1623,4159
19/02/2018,#####,15,2596,1606,4202
19/02/2018,#####,16,2631,1631,4262
19/02/2018,#####,17,2841,1635,4476
19/02/2018,#####,18,3035,1762,4797
19/02/2018,#####,19,2942,1709,4651
19/02/2018,#####,20,2828,1420,4248
19/02/2018,#####,21,2727,1320,4047
19/02/2018,#####,22,2514,1201,3715
19/02/2018,#####,23,2511,1184,3695
20/02/2018,#####,0,2661,1150,3811
20/02/2018,#####,1,2585,1175,3760
20/02/2018,#####,2,2391,1187,3578
20/02/2018,#####,3,2517,1182,3699
20/02/2018,#####,4,2620,1196,3816
20/02/2018,#####,5,2695,1249,3944
20/02/2018,#####,6,3039,1419,4458
20/02/2018,#####,7,3313,1634,4947
20/02/2018,#####,8,3253,1709,4962
20/02/2018,#####,9,3307,1692,4999
20/02/2018,#####,10,3322,1693,5015
20/02/2018,#####,11,2993,1701,4694
20/02/2018,#####,12,2859,1651,4510
20/02/2018,#####,13,3079,1588,4667
20/02/2018,#####,14,2993,1578,4571
20/02/2018,#####,15,2908,1623,4531
20/02/2018,#####,16,2924,1649,4573
20/02/2018,#####,17,2839,1734,4573
20/02/2018,#####,18,2879,1733,4612
20/02/2018,#####,19,2870,1670,4540
20/02/2018,#####,20,2599,1497,4096
20/02/2018,#####,21,2177,1352,3529
20/02/2018,#####,22,2133,1330,3463
20/02/2018,#####,23,2132,1198,3330
21/02/2018,#####,0,2021,1136,3157
21/02/2018,#####,1,1908,1106,3014
21/02/2018,#####,2,1793,1106,2899
21/02/2018,#####,3,1758,1100,2858
21/02/2018,#####,4,1824,1119,2943
21/02/2018,#####,5,1990,1202,3192
21/02/2018,#####,6,2247,1363,3610
21/02/2018,#####,7,2587,1548,4135
21/02/2018,#####,8,2650,1598,4248
21/02/2018,#####,9,2713,1630,4343
21/02/2018,#####,10,2586,1625,4211
21/02/2018,#####,11,2686,1675,4361
21/02/2018,#####,12,2615,1612,4227
21/02/2018,#####,13,2609,1569,4178
21/02/2018,#####,14,2576,1565,4141
21/02/2018,#####,15,2737,1597,4334
21/02/2018,#####,16,2585,1605,4190
21/02/2018,#####,17,2633,1623,4256
21/02/2018,#####,18,2689,1665,4354
21/02/2018,#####,19,2696,1589,4285
21/02/2018,#####,20,2583,1480,4063
21/02/2018,#####,21,2324,1421,3745
21/02/2018,#####,22,2231,1288,3519
21/02/2018,#####,23,2151,1274,3425
22/02/2018,#####,0,1948,1142,3090
22/02/2018,#####,1,1904,1123,3027
22/02/2018,#####,2,1871,1104,2975
22/02/2018,#####,3,1843,1130,2973
22/02/2018,#####,4,1857,1166,3023
22/02/2018,#####,5,2242,1210,3452
22/02/2018,#####,6,2446,1445,3891
22/02/2018,#####,7,2764,1571,4335
22/02/2018,#####,8,2788,1678,4466
22/02/2018,#####,9,2792,1748,4540
22/02/2018,#####,10,2734,1794,4528
22/02/2018,#####,11,2733,1776,4509
22/02/2018,#####,12,2602,1805,4407
22/02/2018,#####,13,2587,1631,4218
22/02/2018,#####,14,2585,1687,4272
22/02/2018,#####,15,2540,1642,4182
22/02/2018,#####,16,2543,1714,4257
22/02/2018,#####,17,2523,1710,4233
22/02/2018,#####,18,2619,1700,4319
22/02/2018,#####,19,2548,1626,4174
22/02/2018,#####,20,2409,1568,3977
22/02/2018,#####,21,2356,1443,3799
22/02/2018,#####,22,2306,1347,3653
22/02/2018,#####,23,2035,1288,3323
23/02/2018,#####,0,1848,1317,3165
23/02/2018,#####,1,1806,1289,3095
23/02/2018,#####,2,1943,1264,3207
23/02/2018,#####,3,1901,1270,3171
23/02/2018,#####,4,1790,1312,3102
23/02/2018,#####,5,2038,1355,3393
23/02/2018,#####,6,2299,1433,3732
23/02/2018,#####,7,2459,1678,4137
23/02/2018,#####,8,2514,1719,4233
23/02/2018,#####,9,2529,1733,4262
23/02/2018,#####,10,2569,1730,4299
23/02/2018,#####,11,2632,1719,4351
23/02/2018,#####,12,2626,1598,4224
23/02/2018,#####,13,2520,1542,4062
23/02/2018,#####,14,2442,1524,3966
23/02/2018,#####,15,2320,1513,3833
23/02/2018,#####,16,2399,1501,3900
23/02/2018,#####,17,2390,1497,3887
23/02/2018,#####,18,2388,1509,3897
23/02/2018,#####,19,2407,1520,3927
23/02/2018,#####,20,2463,1462,3925
23/02/2018,#####,21,2316,1387,3703
23/02/2018,#####,22,2021,1410,3431
23/02/2018,#####,23,2135,1452,3587
24/02/2018,#####,0,2213,1408,3621
24/02/2018,#####,1,2205,1435,3640
24/02/2018,#####,2,2039,1431,3470
24/02/2018,#####,3,2097,1453,3550
24/02/2018,#####,4,2284,1497,3781
24/02/2018,#####,5,2296,1583,3879
24/02/2018,#####,6,2506,1736,4242
24/02/2018,#####,7,2771,1767,4538
24/02/2018,#####,8,2614,1780,4394
24/02/2018,#####,9,2583,1867,4450
24/02/2018,#####,10,2596,1961,4557
24/02/2018,#####,11,2517,1923,4440
24/02/2018,#####,12,2385,1902,4287
24/02/2018,#####,13,2390,1911,4301
24/02/2018,#####,14,2453,1878,4331
24/02/2018,#####,15,2270,1821,4091
24/02/2018,#####,16,2269,1776,4045
24/02/2018,#####,17,2372,1803,4175
24/02/2018,#####,18,2315,1852,4167
24/02/2018,#####,19,2217,1717,3934
24/02/2018,#####,20,2087,1639,3726
24/02/2018,#####,21,2017,1467,3484
24/02/2018,#####,22,1975,1312,3287
24/02/2018,#####,23,1795,1200,2995
25/02/2018,#####,0,1705,1152,2857
25/02/2018,#####,1,1775,1195,2970
25/02/2018,#####,2,1700,1227,2927
25/02/2018,#####,3,1629,1213,2842
25/02/2018,#####,4,1666,1266,2932
25/02/2018,#####,5,1744,1215,2959
25/02/2018,#####,6,1915,1225,3140
25/02/2018,#####,7,2044,1315,3359
25/02/2018,#####,8,2255,1360,3615
25/02/2018,#####,9,2538,1402,3940
25/02/2018,#####,10,2677,1437,4114
25/02/2018,#####,11,2671,1496,4167
25/02/2018,#####,12,2698,1529,4227
25/02/2018,#####,13,2747,1541,4288
25/02/2018,#####,14,2801,1544,4345
25/02/2018,#####,15,2956,1556,4512
25/02/2018,#####,16,3309,1524,4833
25/02/2018,#####,17,3643,1555,5198
25/02/2018,#####,18,3591,1612,5203
25/02/2018,#####,19,3562,1610,5172
25/02/2018,#####,20,3354,1538,4892
25/02/2018,#####,21,3192,1542,4734
25/02/2018,#####,22,3171,1605,4776
25/02/2018,#####,23,3146,1608,4754
26/02/2018,#####,0,3067,1635,4702
26/02/2018,#####,1,3215,1546,4761
26/02/2018,#####,2,3169,1529,4698
26/02/2018,#####,3,3073,1566,4639
26/02/2018,#####,4,2937,1479,4416
26/02/2018,#####,5,2944,1463,4407
26/02/2018,#####,6,3393,1569,4962
26/02/2018,#####,7,3752,1680,5432
26/02/2018,#####,8,3789,1738,5527
26/02/2018,#####,9,3928,1761,5689
26/02/2018,#####,10,4158,1843,6001
26/02/2018,#####,11,4199,1861,6060
26/02/2018,#####,12,3892,1805,5697
26/02/2018,#####,13,3686,1827,5513
26/02/2018,#####,14,3766,1780,5546
26/02/2018,#####,15,4024,1659,5683
26/02/2018,#####,16,3743,1623,5366
26/02/2018,#####,17,4075,1702,5777
26/02/2018,#####,18,3402,1701,5103
26/02/2018,#####,19,3664,1679,5343
26/02/2018,#####,20,3546,1682,5228
26/02/2018,#####,21,3461,1496,4957
26/02/2018,#####,22,3240,1406,4646
26/02/2018,#####,23,3424,1479,4903
27/02/2018,#####,0,3741,1426,5167
27/02/2018,#####,1,3846,1421,5267
27/02/2018,#####,2,3649,1468,5117
27/02/2018,#####,3,3685,1468,5153
27/02/2018,#####,4,4018,1401,5419
27/02/2018,#####,5,4355,1451,5806
27/02/2018,#####,6,4756,1599,6355
27/02/2018,#####,7,4990,1875,6865
27/02/2018,#####,8,5000,1941,6941
27/02/2018,#####,9,5229,1952,7181
27/02/2018,#####,10,5406,2134,7540
27/02/2018,#####,11,5550,2007,7557
27/02/2018,#####,12,5331,1866,7197
27/02/2018,#####,13,5420,1880,7300
27/02/2018,#####,14,5283,1999,7282
27/02/2018,#####,15,5361,2008,7369
27/02/2018,#####,16,4961,1938,6899
27/02/2018,#####,17,5054,1923,6977
27/02/2018,#####,18,5223,2142,7365
27/02/2018,#####,19,5590,2200,7790
27/02/2018,#####,20,5335,2147,7482
27/02/2018,#####,21,5397,1973,7370
27/02/2018,#####,22,4935,1748,6683
27/02/2018,#####,23,4985,1720,6705
28/02/2018,#####,0,4822,1586,6408
28/02/2018,#####,1,4851,1626,6477
28/02/2018,#####,2,4790,1549,6339
28/02/2018,#####,3,4715,1514,6229
28/02/2018,#####,4,4751,1584,6335
28/02/2018,#####,5,4602,1588,6190
28/02/2018,#####,6,5134,1884,7018
28/02/2018,#####,7,5167,2094,7261
28/02/2018,#####,8,5130,2363,7493
28/02/2018,#####,9,5202,2349,7551
28/02/2018,#####,10,4535,2093,6628
28/02/2018,#####,11,4272,1975,6247
28/02/2018,#####,12,4363,1950,6313
28/02/2018,#####,13,4618,1927,6545
28/02/2018,#####,14,4614,1962,6576
28/02/2018,#####,15,4547,1974,6521
28/02/2018,#####,16,4525,1953,6478
28/02/2018,#####,17,4592,2119,6711
28/02/2018,#####,18,4445,2218,6663
28/02/2018,#####,19,4459,2001,6460
28/02/2018,#####,20,4576,1915,6491
28/02/2018,#####,21,4068,1896,5964
28/02/2018,#####,22,4026,1820,5846
28/02/2018,#####,23,4177,1770,5947
01/03/2018,#####,0,4537,1683,6220
01/03/2018,#####,1,4373,1586,5959
01/03/2018,#####,2,3957,1496,5453
01/03/2018,#####,3,3994,1480,5474
01/03/2018,#####,4,4271,1472,5743
01/03/2018,#####,5,4405,1543,5948
01/03/2018,#####,6,4485,1599,6084
01/03/2018,#####,7,4727,1898,6625
01/03/2018,#####,8,5101,1945,7046
01/03/2018,#####,9,5102,1894,6996
01/03/2018,#####,10,4793,1850,6643
01/03/2018,#####,11,4551,1878,6429
01/03/2018,#####,12,4377,1865,6242
01/03/2018,#####,13,4290,1809,6099
01/03/2018,#####,14,4222,1632,5854
01/03/2018,#####,15,4089,1599,5688
01/03/2018,#####,16,4136,1642,5778
01/03/2018,#####,17,4336,1880,6216
01/03/2018,#####,18,4123,2001,6124
01/03/2018,#####,19,4257,1966,6223
01/03/2018,#####,20,4149,1751,5900
01/03/2018,#####,21,4150,1739,5889
01/03/2018,#####,22,3899,1723,5622
01/03/2018,#####,23,4199,1619,5818
02/03/2018,#####,0,4169,1517,5686
02/03/2018,#####,1,4286,1488,5774
02/03/2018,#####,2,4368,1425,5793
02/03/2018,#####,3,4340,1375,5715
02/03/2018,#####,4,4383,1338,5721
02/03/2018,#####,5,4368,1300,5668
02/03/2018,#####,6,4530,1375,5905
02/03/2018,#####,7,4560,1481,6041
02/03/2018,#####,8,4634,1574,6208
02/03/2018,#####,9,4882,1672,6554
02/03/2018,#####,10,4523,1656,6179
02/03/2018,#####,11,4388,1481,5869
02/03/2018,#####,12,4396,1338,5734
02/03/2018,#####,13,4352,1347,5699
02/03/2018,#####,14,4199,1448,5647
02/03/2018,#####,15,4011,1615,5626
02/03/2018,#####,16,4119,1652,5771
02/03/2018,#####,17,3888,1654,5542
02/03/2018,#####,18,3944,1766,5710
02/03/2018,#####,19,4120,1645,5765
02/03/2018,#####,20,3546,1564,5110
02/03/2018,#####,21,3453,1554,5007
02/03/2018,#####,22,3404,1466,4870
02/03/2018,#####,23,3581,1453,5034
03/03/2018,#####,0,3549,1354,4903
03/03/2018,#####,1,3517,1301,4818
03/03/2018,#####,2,3015,1301,4316
03/03/2018,#####,3,2853,1246,4099
03/03/2018,#####,4,2741,1150,3891
03/03/2018,#####,5,2854,1122,3976
03/03/2018,#####,6,2972,1132,4104
03/03/2018,#####,7,3027,1153,4180
03/03/2018,#####,8,3148,1200,4348
03/03/2018,#####,9,3284,1289,4573
03/03/2018,#####,10,3271,1305,4576
03/03/2018,#####,11,3405,1267,4672
03/03/2018,#####,12,3462,1244,4706
03/03/2018,#####,13,3386,1220,4606
03/03/2018,#####,14,3369,1221,4590
03/03/2018,#####,15,3297,1226,4523
03/03/2018,#####,16,3281,1186,4467
03/03/2018,#####,17,3303,1230,4533
03/03/2018,#####,18,3330,1282,4612
03/03/2018,#####,19,3325,1342,4667
03/03/2018,#####,20,3359,1435,4794
03/03/2018,#####,21,3331,1380,4711
03/03/2018,#####,22,3358,1393,4751
03/03/2018,#####,23,3222,1379,4601
04/03/2018,#####,0,2921,1277,4198
04/03/2018,#####,1,2865,1226,4091
04/03/2018,#####,2,2775,1174,3949
04/03/2018,#####,3,2763,1119,3882
04/03/2018,#####,4,2849,1121,3970
04/03/2018,#####,5,2891,1172,4063
04/03/2018,#####,6,2929,1263,4192
04/03/2018,#####,7,3061,1307,4368
04/03/2018,#####,8,3243,1378,4621
04/03/2018,#####,9,3668,1483,5151
04/03/2018,#####,10,3797,1557,5354
04/03/2018,#####,11,4018,1555,5573
04/03/2018,#####,12,3976,1520,5496
04/03/2018,#####,13,4006,1496,5502
04/03/2018,#####,14,3978,1408,5386
04/03/2018,#####,15,3904,1390,5294
04/03/2018,#####,16,4053,1412,5465
04/03/2018,#####,17,3842,1422,5264
04/03/2018,#####,18,3943,1369,5312
04/03/2018,#####,19,3763,1395,5158
04/03/2018,#####,20,3629,1371,5000
04/03/2018,#####,21,3554,1320,4874
04/03/2018,#####,22,3598,1273,4871
04/03/2018,#####,23,3479,1221,4700
05/03/2018,#####,0,3426,1239,4665
05/03/2018,#####,1,3458,1265,4723
05/03/2018,#####,2,3662,1327,4989
05/03/2018,#####,3,3777,1356,5133
05/03/2018,#####,4,4207,1383,5590
05/03/2018,#####,5,4367,1394,5761
05/03/2018,#####,6,5059,1353,6412
05/03/2018,#####,7,5230,1344,6574
05/03/2018,#####,8,5212,1401,6613
05/03/2018,#####,9,4695,1394,6089
05/03/2018,#####,10,4591,1349,5940
05/03/2018,#####,11,4553,1319,5872
05/03/2018,#####,12,4335,1317,5652
05/03/2018,#####,13,4121,1319,5440
05/03/2018,#####,14,4399,1365,5764
05/03/2018,#####,15,4406,1361,5767
05/03/2018,#####,16,4337,1408,5745
05/03/2018,#####,17,4426,1502,5928
05/03/2018,#####,18,4294,1557,5851
05/03/2018,#####,19,3995,1651,5646
05/03/2018,#####,20,3575,1505,5080
05/03/2018,#####,21,3075,1415,4490
05/03/2018,#####,22,2752,1326,4078
05/03/2018,#####,23,2603,1197,3800
06/03/2018,#####,0,2567,1182,3749
06/03/2018,#####,1,2417,1144,3561
06/03/2018,#####,2,2262,1101,3363
06/03/2018,#####,3,2134,1111,3245
06/03/2018,#####,4,2038,1106,3144
06/03/2018,#####,5,2128,1100,3228
06/03/2018,#####,6,2349,1138,3487
06/03/2018,#####,7,2628,1272,3900
06/03/2018,#####,8,2651,1309,3960
06/03/2018,#####,9,2751,1361,4112
06/03/2018,#####,10,2719,1412,4131
06/03/2018,#####,11,2949,1485,4434
06/03/2018,#####,12,3151,1492,4643
06/03/2018,#####,13,3157,1504,4661
06/03/2018,#####,14,3164,1521,4685
06/03/2018,#####,15,3223,1477,4700
06/03/2018,#####,16,3306,1483,4789
06/03/2018,#####,17,3427,1457,4884
06/03/2018,#####,18,3500,1447,4947
06/03/2018,#####,19,3509,1454,4963
06/03/2018,#####,20,3340,1430,4770
06/03/2018,#####,21,3352,1303,4655
06/03/2018,#####,22,3404,1221,4625
06/03/2018,#####,23,3155,1180,4335
07/03/2018,#####,0,3166,1225,4391
07/03/2018,#####,1,3116,1145,4261
07/03/2018,#####,2,3070,1143,4213
07/03/2018,#####,3,3168,1187,4355
07/03/2018,#####,4,3165,1172,4337
07/03/2018,#####,5,3261,1211,4472
07/03/2018,#####,6,3451,1271,4722
07/03/2018,#####,7,3606,1333,4939
07/03/2018,#####,8,3629,1395,5024
07/03/2018,#####,9,3360,1446,4806
07/03/2018,#####,10,3296,1444,4740
07/03/2018,#####,11,3263,1431,4694
07/03/2018,#####,12,3104,1418,4522
07/03/2018,#####,13,2994,1353,4347
07/03/2018,#####,14,2975,1401,4376
07/03/2018,#####,15,2839,1389,4228
07/03/2018,#####,16,2779,1336,4115
07/03/2018,#####,17,2884,1382,4266
07/03/2018,#####,18,3053,1369,4422
07/03/2018,#####,19,2963,1359,4322
07/03/2018,#####,20,2784,1253,4037
07/03/2018,#####,21,2610,1198,3808
07/03/2018,#####,22,2449,1135,3584
07/03/2018,#####,23,2014,1086,3100
08/03/2018,#####,0,1871,1058,2929
08/03/2018,#####,1,1802,1008,2810
08/03/2018,#####,2,1751,1000,2751
08/03/2018,#####,3,1840,958,2798
08/03/2018,#####,4,1874,1031,2905
08/03/2018,#####,5,1868,1055,2923
08/03/2018,#####,6,2512,1096,3608
08/03/2018,#####,7,2669,1144,3813
08/03/2018,#####,8,2608,1185,3793
08/03/2018,#####,9,2623,1232,3855
08/03/2018,#####,10,2639,1256,3895
08/03/2018,#####,11,2602,1269,3871
08/03/2018,#####,12,2509,1289,3798
08/03/2018,#####,13,2455,1325,3780
08/03/2018,#####,14,2495,1404,3899
08/03/2018,#####,15,2552,1302,3854
08/03/2018,#####,16,2522,1228,3750
08/03/2018,#####,17,2684,1271,3955
08/03/2018,#####,18,2813,1292,4105
08/03/2018,#####,19,2850,1459,4309
08/03/2018,#####,20,2305,1479,3784
08/03/2018,#####,21,2230,1394,3624
08/03/2018,#####,22,2147,1363,3510
08/03/2018,#####,23,2031,1349,3380
09/03/2018,#####,0,1991,1292,3283
09/03/2018,#####,1,2100,1324,3424
09/03/2018,#####,2,2155,1294,3449
09/03/2018,#####,3,2056,1343,3399
09/03/2018,#####,4,2059,1344,3403
09/03/2018,#####,5,2156,1395,3551
09/03/2018,#####,6,2189,1445,3634
09/03/2018,#####,7,2430,1484,3914
09/03/2018,#####,8,2555,1564,4119
09/03/2018,#####,9,2611,1488,4099
09/03/2018,#####,10,2625,1423,4048
09/03/2018,#####,11,2670,1408,4078
09/03/2018,#####,12,2677,1471,4148
09/03/2018,#####,13,2591,1520,4111
09/03/2018,#####,14,2562,1445,4007
09/03/2018,#####,15,2646,1351,3997
09/03/2018,#####,16,2618,1330,3948
09/03/2018,#####,17,2616,1473,4089
09/03/2018,#####,18,2622,1474,4096
09/03/2018,#####,19,2520,1424,3944
09/03/2018,#####,20,2474,1342,3816
09/03/2018,#####,21,2407,1236,3643
09/03/2018,#####,22,2334,1165,3499
09/03/2018,#####,23,2375,1096,3471
10/03/2018,#####,0,2174,1064,3238
10/03/2018,#####,1,1755,1056,2811
10/03/2018,#####,2,1744,1024,2768
10/03/2018,#####,3,1962,1049,3011
10/03/2018,#####,4,2069,1065,3134
10/03/2018,#####,5,2370,1094,3464
10/03/2018,#####,6,2594,1123,3717
10/03/2018,#####,7,2777,1179,3956
10/03/2018,#####,8,2913,1305,4218
10/03/2018,#####,9,3170,1439,4609
10/03/2018,#####,10,3345,1505,4850
10/03/2018,#####,11,3380,1564,4944
10/03/2018,#####,12,3317,1607,4924
10/03/2018,#####,13,3345,1595,4940
10/03/2018,#####,14,3462,1647,5109
10/03/2018,#####,15,3590,1645,5235
10/03/2018,#####,16,4069,1681,5750
10/03/2018,#####,17,4400,1679,6079
10/03/2018,#####,18,4851,1790,6641
10/03/2018,#####,19,4908,1802,6710
10/03/2018,#####,20,4567,1740,6307
10/03/2018,#####,21,4091,1604,5695
10/03/2018,#####,22,3749,1497,5246
10/03/2018,#####,23,3538,1364,4902
11/03/2018,#####,0,3550,1232,4782
11/03/2018,#####,1,3479,1158,4637
11/03/2018,#####,2,3519,1086,4605
11/03/2018,#####,3,3456,1082,4538
11/03/2018,#####,4,3360,996,4356
11/03/2018,#####,5,3315,1012,4327
11/03/2018,#####,6,3187,1005,4192
11/03/2018,#####,7,3091,1089,4180
11/03/2018,#####,8,3116,1129,4245
11/03/2018,#####,9,3300,1239,4539
11/03/2018,#####,10,3275,1289,4564
11/03/2018,#####,11,3282,1342,4624
11/03/2018,#####,12,3213,1321,4534
11/03/2018,#####,13,3213,1314,4527
11/03/2018,#####,14,3177,1437,4614
11/03/2018,#####,15,3240,1424,4664
11/03/2018,#####,16,3343,1451,4794
11/03/2018,#####,17,3542,1547,5089
11/03/2018,#####,18,3871,1639,5510
11/03/2018,#####,19,4066,1667,5733
11/03/2018,#####,20,3850,1593,5443
11/03/2018,#####,21,4028,1547,5575
11/03/2018,#####,22,4089,1522,5611
11/03/2018,#####,23,3894,1521,5415
12/03/2018,#####,0,3246,1324,4570
12/03/2018,#####,1,2942,1203,4145
12/03/2018,#####,2,2557,1140,3697
12/03/2018,#####,3,2259,1036,3295
12/03/2018,#####,4,2416,1137,3553
12/03/2018,#####,5,2566,1196,3762
12/03/2018,#####,6,2764,1301,4065
12/03/2018,#####,7,2845,1445,4290
12/03/2018,#####,8,2817,1543,4360
12/03/2018,#####,9,2762,1582,4344
12/03/2018,#####,10,2799,1591,4390
12/03/2018,#####,11,2931,1563,4494
12/03/2018,#####,12,2713,1543,4256
12/03/2018,#####,13,2927,1536,4463
12/03/2018,#####,14,2586,1447,4033
12/03/2018,#####,15,2528,1452,3980
12/03/2018,#####,16,2516,1466,3982
12/03/2018,#####,17,2806,1484,4290
12/03/2018,#####,18,2892,1512,4404
12/03/2018,#####,19,2993,1572,4565
12/03/2018,#####,20,2592,1384,3976
12/03/2018,#####,21,2272,1331,3603
12/03/2018,#####,22,2113,1271,3384
12/03/2018,#####,23,1945,1251,3196
13/03/2018,#####,0,1940,1155,3095
13/03/2018,#####,1,2050,1145,3195
13/03/2018,#####,2,2013,1106,3119
13/03/2018,#####,3,2092,1076,3168
13/03/2018,#####,4,2237,1156,3393
13/03/2018,#####,5,2341,1292,3633
13/03/2018,#####,6,2759,1329,4088
13/03/2018,#####,7,3021,1460,4481
13/03/2018,#####,8,3075,1430,4505
13/03/2018,#####,9,3086,1470,4556
13/03/2018,#####,10,3302,1628,4930
13/03/2018,#####,11,3108,1521,4629
13/03/2018,#####,12,3291,1501,4792
13/03/2018,#####,13,3276,1518,4794
13/03/2018,#####,14,3276,1520,4796
13/03/2018,#####,15,3327,1551,4878
13/03/2018,#####,16,3269,1531,4800
13/03/2018,#####,17,3210,1567,4777
13/03/2018,#####,18,3140,1564,4704
13/03/2018,#####,19,3061,1563,4624
13/03/2018,#####,20,2888,1524,4412
13/03/2018,#####,21,2748,1433,4181
13/03/2018,#####,22,2524,1334,3858
13/03/2018,#####,23,2165,1310,3475
14/03/2018,#####,0,2017,1233,3250
14/03/2018,#####,1,1983,1182,3165
14/03/2018,#####,2,1957,1200,3157
14/03/2018,#####,3,1914,1193,3107
14/03/2018,#####,4,1865,1198,3063
14/03/2018,#####,5,1919,1289,3208
14/03/2018,#####,6,2458,1361,3819
14/03/2018,#####,7,2764,1524,4288
14/03/2018,#####,8,2811,1576,4387
14/03/2018,#####,9,2851,1610,4461
14/03/2018,#####,10,2896,1584,4480
14/03/2018,#####,11,2826,1529,4355
14/03/2018,#####,12,2592,1447,4039
14/03/2018,#####,13,2486,1416,3902
14/03/2018,#####,14,2346,1379,3725
14/03/2018,#####,15,2501,1368,3869
14/03/2018,#####,16,2492,1375,3867
14/03/2018,#####,17,2693,1396,4089
14/03/2018,#####,18,2956,1426,4382
14/03/2018,#####,19,3092,1480,4572
14/03/2018,#####,20,2887,1470,4357
14/03/2018,#####,21,2127,1427,3554
14/03/2018,#####,22,2106,1432,3538
14/03/2018,#####,23,2183,1401,3584
15/03/2018,#####,0,2244,1379,3623
15/03/2018,#####,1,2327,1442,3769
15/03/2018,#####,2,2361,1495,3856
15/03/2018,#####,3,2530,1566,4096
15/03/2018,#####,4,2975,1685,4660
15/03/2018,#####,5,3334,1844,5178
15/03/2018,#####,6,3691,1914,5605
15/03/2018,#####,7,4079,2045,6124
15/03/2018,#####,8,3910,2161,6071
15/03/2018,#####,9,4251,2189,6440
15/03/2018,#####,10,4181,2220,6401
15/03/2018,#####,11,4171,2247,6418
15/03/2018,#####,12,3961,2291,6252
15/03/2018,#####,13,3946,2291,6237
15/03/2018,#####,14,3889,2263,6152
15/03/2018,#####,15,3975,2257,6232
15/03/2018,#####,16,3982,2213,6195
15/03/2018,#####,17,4086,2236,6322
15/03/2018,#####,18,4152,2287,6439
15/03/2018,#####,19,4054,2299,6353
15/03/2018,#####,20,3856,2232,6088
15/03/2018,#####,21,3789,2183,5972
15/03/2018,#####,22,3763,2171,5934
15/03/2018,#####,23,3902,2120,6022
16/03/2018,#####,0,3905,2089,5994
16/03/2018,#####,1,3506,2077,5583
16/03/2018,#####,2,3407,2098,5505
16/03/2018,#####,3,3700,2123,5823
16/03/2018,#####,4,3943,2102,6045
16/03/2018,#####,5,4013,2127,6140
16/03/2018,#####,6,4312,2264,6576
16/03/2018,#####,7,4383,2354,6737
16/03/2018,#####,8,4572,2447,7019
16/03/2018,#####,9,4540,2491,7031
16/03/2018,#####,10,4576,2485,7061
16/03/2018,#####,11,4520,2476,6996
16/03/2018,#####,12,4350,2453,6803
16/03/2018,#####,13,4213,2459,6672
16/03/2018,#####,14,4294,2449,6743
16/03/2018,#####,15,4315,2421,6736
16/03/2018,#####,16,4361,2405,6766
16/03/2018,#####,17,4486,2367,6853
16/03/2018,#####,18,4517,2364,6881
16/03/2018,#####,19,4449,2372,6821
16/03/2018,#####,20,4338,2242,6580
16/03/2018,#####,21,4106,2159,6265
16/03/2018,#####,22,4024,2083,6107
16/03/2018,#####,23,3949,2079,6028
17/03/2018,#####,0,3835,1834,5669
17/03/2018,#####,1,3631,1826,5457
17/03/2018,#####,2,3555,1748,5303
17/03/2018,#####,3,3691,1737,5428
17/03/2018,#####,4,3554,1779,5333
17/03/2018,#####,5,3539,1810,5349
17/03/2018,#####,6,3451,1823,5274
17/03/2018,#####,7,3609,1869,5478
17/03/2018,#####,8,3651,1984,5635
17/03/2018,#####,9,3706,2107,5813
17/03/2018,#####,10,3807,2170,5977
17/03/2018,#####,11,3922,2117,6039
17/03/2018,#####,12,3853,2122,5975
17/03/2018,#####,13,3726,2107,5833
17/03/2018,#####,14,3636,2115,5751
17/03/2018,#####,15,3826,2062,5888
17/03/2018,#####,16,3856,2041,5897
17/03/2018,#####,17,3907,2123,6030
17/03/2018,#####,18,3814,2124,5938
17/03/2018,#####,19,3667,2102,5769
17/03/2018,#####,20,3285,2076,5361
17/03/2018,#####,21,2912,2040,4952
17/03/2018,#####,22,3608,1949,5557
17/03/2018,#####,23,3115,1785,4900
18/03/2018,#####,0,2655,1791,4446
18/03/2018,#####,1,2657,1638,4295
18/03/2018,#####,2,2526,1777,4303
18/03/2018,#####,3,2244,1767,4011
18/03/2018,#####,4,2272,1771,4043
18/03/2018,#####,5,2230,1785,4015
18/03/2018,#####,6,2512,1889,4401
18/03/2018,#####,7,2526,1850,4376
18/03/2018,#####,8,2955,2000,4955
18/03/2018,#####,9,2735,2102,4837
18/03/2018,#####,10,2757,2168,4925
18/03/2018,#####,11,2731,2172,4903
18/03/2018,#####,12,2972,2116,5088
18/03/2018,#####,13,2963,2102,5065
18/03/2018,#####,14,2934,2089,5023
18/03/2018,#####,15,2898,2015,4913
18/03/2018,#####,16,2872,1957,4829
18/03/2018,#####,17,2639,1852,4491
18/03/2018,#####,18,2410,1706,4116
18/03/2018,#####,19,2342,1706,4048
18/03/2018,#####,20,2128,1596,3724
18/03/2018,#####,21,1766,1514,3280
18/03/2018,#####,22,1854,1414,3268
18/03/2018,#####,23,1655,1328,2983
19/03/2018,#####,0,1858,1321,3179
19/03/2018,#####,1,1688,1263,2951
19/03/2018,#####,2,1676,1186,2862
19/03/2018,#####,3,1687,1170,2857
19/03/2018,#####,4,1779,1170,2949
19/03/2018,#####,5,2108,1056,3164
19/03/2018,#####,6,2773,1082,3855
19/03/2018,#####,7,3100,1305,4405
19/03/2018,#####,8,3332,1370,4702
19/03/2018,#####,9,3454,1353,4807
19/03/2018,#####,10,3701,1428,5129
19/03/2018,#####,11,3705,1494,5199
19/03/2018,#####,12,3778,1504,5282
19/03/2018,#####,13,3739,1515,5254
19/03/2018,#####,14,3781,1409,5190
19/03/2018,#####,15,3849,1427,5276
19/03/2018,#####,16,3986,1452,5438
19/03/2018,#####,17,4092,1525,5617
19/03/2018,#####,18,4097,1389,5486
19/03/2018,#####,19,4315,1521,5836
19/03/2018,#####,20,4307,1521,5828
19/03/2018,#####,21,3974,1576,5550
19/03/2018,#####,22,3696,1637,5333
19/03/2018,#####,23,3891,1555,5446
20/03/2018,#####,0,3709,1481,5190
20/03/2018,#####,1,3117,1490,4607
20/03/2018,#####,2,3151,1557,4708
20/03/2018,#####,3,3021,1672,4693
20/03/2018,#####,4,3175,1844,5019
20/03/2018,#####,5,3147,1891,5038
20/03/2018,#####,6,3063,1977,5040
20/03/2018,#####,7,3142,1986,5128
20/03/2018,#####,8,3556,2090,5646
20/03/2018,#####,9,3867,2122,5989
20/03/2018,#####,10,3730,1999,5729
20/03/2018,#####,11,3625,1987,5612
20/03/2018,#####,12,3397,1978,5375
20/03/2018,#####,13,3210,1872,5082
20/03/2018,#####,14,2928,1885,4813
20/03/2018,#####,15,2711,1926,4637
20/03/2018,#####,16,2528,1815,4343
20/03/2018,#####,17,2677,1528,4205
20/03/2018,#####,18,2691,1421,4112
20/03/2018,#####,19,2709,1568,4277
20/03/2018,#####,20,2507,1485,3992
20/03/2018,#####,21,2262,1433,3695
20/03/2018,#####,22,2343,1383,3726
20/03/2018,#####,23,1941,1310,3251
21/03/2018,#####,0,2265,1257,3522
21/03/2018,#####,1,2163,1250,3413
21/03/2018,#####,2,2203,1229,3432
21/03/2018,#####,3,2292,1258,3550
21/03/2018,#####,4,2412,1301,3713
21/03/2018,#####,5,3000,1347,4347
21/03/2018,#####,6,3341,1494,4835
21/03/2018,#####,7,3544,1581,5125
21/03/2018,#####,8,3537,1675,5212
21/03/2018,#####,9,3575,1691,5266
21/03/2018,#####,10,3810,1728,5538
21/03/2018,#####,11,4016,1751,5767
21/03/2018,#####,12,4092,1900,5992
21/03/2018,#####,13,4272,1906,6178
21/03/2018,#####,14,4117,1923,6040
21/03/2018,#####,15,4135,1834,5969
21/03/2018,#####,16,3974,1854,5828
21/03/2018,#####,17,3939,1931,5870
21/03/2018,#####,18,4017,1900,5917
21/03/2018,#####,19,4038,1877,5915
21/03/2018,#####,20,4137,1837,5974
21/03/2018,#####,21,3866,1774,5640
21/03/2018,#####,22,3643,1774,5417
21/03/2018,#####,23,3645,1684,5329
22/03/2018,#####,0,3104,1673,4777
22/03/2018,#####,1,2974,1653,4627
22/03/2018,#####,2,2912,1596,4508
22/03/2018,#####,3,2906,1606,4512
22/03/2018,#####,4,2630,1591,4221
22/03/2018,#####,5,2323,1640,3963
22/03/2018,#####,6,2227,1734,3961
22/03/2018,#####,7,2291,1836,4127
22/03/2018,#####,8,2530,1872,4402
22/03/2018,#####,9,2420,1801,4221
22/03/2018,#####,10,2429,1663,4092
22/03/2018,#####,11,2363,1515,3878
22/03/2018,#####,12,2291,1471,3762
22/03/2018,#####,13,2273,1494,3767
22/03/2018,#####,14,2251,1536,3787
22/03/2018,#####,15,2505,1614,4119
22/03/2018,#####,16,2569,1445,4014
22/03/2018,#####,17,2593,1406,3999
22/03/2018,#####,18,2596,1473,4069
22/03/2018,#####,19,2701,1530,4231
22/03/2018,#####,20,2629,1467,4096
22/03/2018,#####,21,2372,1346,3718
22/03/2018,#####,22,2181,1283,3464
22/03/2018,#####,23,2053,1248,3301
23/03/2018,#####,0,1894,1313,3207
23/03/2018,#####,1,1800,1360,3160
23/03/2018,#####,2,1940,1321,3261
23/03/2018,#####,3,2046,1313,3359
23/03/2018,#####,4,2162,1341,3503
23/03/2018,#####,5,2368,1412,3780
23/03/2018,#####,6,2681,1493,4174
23/03/2018,#####,7,2993,1546,4539
23/03/2018,#####,8,2984,1541,4525
23/03/2018,#####,9,3003,1659,4662
23/03/2018,#####,10,3431,1622,5053
23/03/2018,#####,11,3518,1583,5101
23/03/2018,#####,12,3606,1529,5135
23/03/2018,#####,13,3685,1478,5163
23/03/2018,#####,14,3603,1449,5052
23/03/2018,#####,15,3566,1425,4991
23/03/2018,#####,16,3569,1371,4940
23/03/2018,#####,17,3727,1409,5136
23/03/2018,#####,18,3708,1460,5168
23/03/2018,#####,19,3666,1423,5089
23/03/2018,#####,20,3572,1432,5004
23/03/2018,#####,21,3428,1403,4831
23/03/2018,#####,22,3115,1395,4510
23/03/2018,#####,23,3046,1386,4432
24/03/2018,#####,0,2849,1376,4225
24/03/2018,#####,1,2985,1328,4313
24/03/2018,#####,2,2927,1332,4259
24/03/2018,#####,3,2944,1327,4271
24/03/2018,#####,4,2906,1351,4257
24/03/2018,#####,5,2917,1338,4255
24/03/2018,#####,6,2887,1305,4192
24/03/2018,#####,7,2916,1333,4249
24/03/2018,#####,8,2862,1355,4217
24/03/2018,#####,9,2861,1426,4287
24/03/2018,#####,10,2701,1553,4254
24/03/2018,#####,11,2909,1451,4360
24/03/2018,#####,12,2863,1460,4323
24/03/2018,#####,13,2725,1407,4132
24/03/2018,#####,14,2399,1376,3775
24/03/2018,#####,15,2193,1360,3553
24/03/2018,#####,16,2425,1337,3762
24/03/2018,#####,17,2707,1333,4040
24/03/2018,#####,18,2672,1336,4008
24/03/2018,#####,19,2662,1318,3980
24/03/2018,#####,20,2560,1372,3932
24/03/2018,#####,21,2562,1376,3938
24/03/2018,#####,22,2383,1378,3761
24/03/2018,#####,23,2046,1303,3349
25/03/2018,#####,0,2066,1245,3311
25/03/2018,#####,1,1775,1190,2965
25/03/2018,#####,2,,,
25/03/2018,#####,3,1595,1068,2663
25/03/2018,#####,4,1672,1043,2715
25/03/2018,#####,5,1650,1017,2667
25/03/2018,#####,6,1884,1025,2909
25/03/2018,#####,7,1835,1120,2955
25/03/2018,#####,8,1966,1139,3105
25/03/2018,#####,9,2105,1158,3263
25/03/2018,#####,10,2121,1278,3399
25/03/2018,#####,11,2134,1260,3394
25/03/2018,#####,12,1857,1267,3124
25/03/2018,#####,13,1775,1270,3045
25/03/2018,#####,14,1870,1241,3111
25/03/2018,#####,15,1841,1189,3030
25/03/2018,#####,16,1730,1137,2867
25/03/2018,#####,17,1795,1153,2948
25/03/2018,#####,18,2151,1154,3305
25/03/2018,#####,19,2431,1193,3624
25/03/2018,#####,20,2577,1223,3800
25/03/2018,#####,21,2528,1195,3723
25/03/2018,#####,22,2397,1200,3597
25/03/2018,#####,23,2245,1251,3496
26/03/2018,#####,0,1882,1123,3005
26/03/2018,#####,1,1762,1020,2782
26/03/2018,#####,2,1899,1030,2929
26/03/2018,#####,3,1980,1084,3064
26/03/2018,#####,4,2070,1101,3171
26/03/2018,#####,5,2277,1130,3407
26/03/2018,#####,6,2747,1323,4070
26/03/2018,#####,7,2947,1404,4351
26/03/2018,#####,8,3026,1606,4632
26/03/2018,#####,9,3047,1715,4762
26/03/2018,#####,10,3101,1689,4790
26/03/2018,#####,11,3358,1684,5042
26/03/2018,#####,12,3183,1691,4874
26/03/2018,#####,13,3108,1674,4782
26/03/2018,#####,14,3091,1688,4779
26/03/2018,#####,15,3050,1632,4682
26/03/2018,#####,16,2958,1580,4538
26/03/2018,#####,17,2970,1538,4508
26/03/2018,#####,18,2854,1570,4424
26/03/2018,#####,19,2634,1595,4229
26/03/2018,#####,20,2600,1539,4139
26/03/2018,#####,21,2487,1525,4012
26/03/2018,#####,22,2355,1480,3835
26/03/2018,#####,23,2311,1470,3781
27/03/2018,#####,0,2261,1491,3752
27/03/2018,#####,1,2161,1456,3617
27/03/2018,#####,2,2097,1444,3541
27/03/2018,#####,3,2036,1432,3468
27/03/2018,#####,4,2010,1454,3464
27/03/2018,#####,5,2207,1459,3666
27/03/2018,#####,6,2640,1525,4165
27/03/2018,#####,7,2956,1803,4759
27/03/2018,#####,8,3127,1931,5058
27/03/2018,#####,9,2975,1897,4872
27/03/2018,#####,10,2996,1802,4798
27/03/2018,#####,11,2986,1739,4725
27/03/2018,#####,12,2967,1637,4604
27/03/2018,#####,13,3169,1572,4741
27/03/2018,#####,14,3328,1303,4631
27/03/2018,#####,15,3528,1277,4805
27/03/2018,#####,16,3619,1244,4863
27/03/2018,#####,17,3510,1247,4757
27/03/2018,#####,18,3784,1246,5030
27/03/2018,#####,19,3674,1322,4996
27/03/2018,#####,20,4047,1296,5343
27/03/2018,#####,21,4013,1218,5231
27/03/2018,#####,22,3935,1226,5161
27/03/2018,#####,23,3867,1254,5121
28/03/2018,#####,0,3772,1293,5065
28/03/2018,#####,1,3646,1419,5065
28/03/2018,#####,2,3902,1554,5456
28/03/2018,#####,3,3932,1618,5550
28/03/2018,#####,4,4283,1677,5960
28/03/2018,#####,5,4488,1736,6224
28/03/2018,#####,6,4501,1818,6319
28/03/2018,#####,7,4063,1905,5968
28/03/2018,#####,8,3732,1958,5690
28/03/2018,#####,9,3945,2038,5983
28/03/2018,#####,10,4063,2045,6108
28/03/2018,#####,11,4338,2073,6411
28/03/2018,#####,12,4360,2078,6438
28/03/2018,#####,13,4379,2097,6476
28/03/2018,#####,14,4454,2081,6535
28/03/2018,#####,15,4457,2123,6580
28/03/2018,#####,16,4424,2091,6515
28/03/2018,#####,17,4263,2068,6331
28/03/2018,#####,18,4302,2064,6366
28/03/2018,#####,19,4296,2030,6326
28/03/2018,#####,20,4513,1955,6468
28/03/2018,#####,21,4583,1900,6483
28/03/2018,#####,22,4211,1881,6092
28/03/2018,#####,23,3927,1806,5733
29/03/2018,#####,0,3801,1769,5570
29/03/2018,#####,1,3743,1808,5551
29/03/2018,#####,2,3761,1843,5604
29/03/2018,#####,3,3661,1856,5517
29/03/2018,#####,4,3749,1781,5530
29/03/2018,#####,5,3854,1817,5671
29/03/2018,#####,6,4137,1922,6059
29/03/2018,#####,7,4318,1992,6310
29/03/2018,#####,8,4431,1991,6422
29/03/2018,#####,9,4754,1971,6725
29/03/2018,#####,10,4709,1934,6643
29/03/2018,#####,11,4568,1843,6411
29/03/2018,#####,12,4318,1680,5998
29/03/2018,#####,13,4076,1585,5661
29/03/2018,#####,14,3956,1507,5463
29/03/2018,#####,15,3915,1497,5412
29/03/2018,#####,16,3650,1483,5133
29/03/2018,#####,17,3966,1456,5422
29/03/2018,#####,18,3758,1448,5206
29/03/2018,#####,19,3538,1385,4923
29/03/2018,#####,20,3311,1434,4745
29/03/2018,#####,21,3067,1371,4438
29/03/2018,#####,22,2859,1335,4194
29/03/2018,#####,23,2491,1290,3781
30/03/2018,#####,0,2142,1317,3459
30/03/2018,#####,1,2244,1277,3521
30/03/2018,#####,2,2337,1265,3602
30/03/2018,#####,3,2455,1252,3707
30/03/2018,#####,4,2328,1229,3557
30/03/2018,#####,5,2452,1233,3685
30/03/2018,#####,6,2439,1217,3656
30/03/2018,#####,7,2692,1225,3917
30/03/2018,#####,8,2792,1247,4039
30/03/2018,#####,9,2805,1276,4081
30/03/2018,#####,10,2862,1333,4195
30/03/2018,#####,11,2947,1366,4313
30/03/2018,#####,12,2931,1326,4257
30/03/2018,#####,13,2967,1332,4299
30/03/2018,#####,14,2893,1387,4280
30/03/2018,#####,15,2752,1396,4148
30/03/2018,#####,16,2798,1405,4203
30/03/2018,#####,17,3049,1371,4420
30/03/2018,#####,18,3119,1415,4534
30/03/2018,#####,19,3078,1452,4530
30/03/2018,#####,20,3029,1514,4543
30/03/2018,#####,21,2946,1562,4508
30/03/2018,#####,22,2917,1567,4484
30/03/2018,#####,23,2921,1595,4516
31/03/2018,#####,0,3047,1620,4667
31/03/2018,#####,1,2932,1519,4451
31/03/2018,#####,2,2679,1505,4184
31/03/2018,#####,3,2556,1522,4078
31/03/2018,#####,4,2532,1486,4018
31/03/2018,#####,5,3070,1507,4577
31/03/2018,#####,6,3365,1552,4917
31/03/2018,#####,7,3496,1641,5137
31/03/2018,#####,8,3863,1688,5551
31/03/2018,#####,9,4207,1744,5951
31/03/2018,#####,10,4110,1784,5894
31/03/2018,#####,11,3880,1773,5653
31/03/2018,#####,12,3612,1799,5411
31/03/2018,#####,13,3435,1704,5139
31/03/2018,#####,14,3085,1696,4781
31/03/2018,#####,15,2877,1701,4578
31/03/2018,#####,16,2776,1702,4478
31/03/2018,#####,17,2931,1715,4646
31/03/2018,#####,18,3118,1746,4864
31/03/2018,#####,19,2943,1697,4640
31/03/2018,#####,20,2734,1636,4370
31/03/2018,#####,21,2563,1611,4174
31/03/2018,#####,22,2456,1544,4000
31/03/2018,#####,23,2381,1445,3826
01/04/2018,#####,0,2047,1319,3366
01/04/2018,#####,1,1962,1282,3244
01/04/2018,#####,2,1896,1279,3175
01/04/2018,#####,3,1843,1295,3138
01/04/2018,#####,4,1912,1335,3247
01/04/2018,#####,5,2110,1354,3464
01/04/2018,#####,6,2200,1335,3535
01/04/2018,#####,7,2276,1353,3629
01/04/2018,#####,8,2471,1401,3872
01/04/2018,#####,9,2824,1518,4342
01/04/2018,#####,10,3245,1623,4868
01/04/2018,#####,11,3492,1495,4987
01/04/2018,#####,12,3516,1492,5008
01/04/2018,#####,13,3466,1579,5045
01/04/2018,#####,14,3495,1650,5145
01/04/2018,#####,15,3081,1669,4750
01/04/2018,#####,16,3052,1602,4654
01/04/2018,#####,17,3244,1552,4796
01/04/2018,#####,18,3208,1517,4725
01/04/2018,#####,19,2810,1482,4292
01/04/2018,#####,20,2510,1378,3888
01/04/2018,#####,21,2208,1398,3606
01/04/2018,#####,22,2235,1412,3647
01/04/2018,#####,23,2060,1383,3443
02/04/2018,#####,0,2421,1465,3886
02/04/2018,#####,1,2238,1494,3732
02/04/2018,#####,2,2219,1439,3658
02/04/2018,#####,3,2026,1245,3271
02/04/2018,#####,4,2127,1221,3348
02/04/2018,#####,5,2292,1228,3520
02/04/2018,#####,6,2235,1199,3434
02/04/2018,#####,7,2258,1256,3514
02/04/2018,#####,8,2280,1310,3590
02/04/2018,#####,9,2462,1432,3894
02/04/2018,#####,10,2654,1518,4172
02/04/2018,#####,11,2558,1475,4033
02/04/2018,#####,12,2446,1500,3946
02/04/2018,#####,13,2327,1525,3852
02/04/2018,#####,14,2195,1471,3666
02/04/2018,#####,15,2060,1405,3465
02/04/2018,#####,16,1865,1319,3184
02/04/2018,#####,17,1806,1225,3031
02/04/2018,#####,18,1754,1217,2971
02/04/2018,#####,19,1812,1191,3003
02/04/2018,#####,20,1790,1215,3005
02/04/2018,#####,21,1691,1236,2927
02/04/2018,#####,22,1889,1242,3131
02/04/2018,#####,23,2112,1205,3317
03/04/2018,#####,0,2330,1230,3560
03/04/2018,#####,1,2270,1268,3538
03/04/2018,#####,2,2353,1318,3671
03/04/2018,#####,3,2647,1337,3984
03/04/2018,#####,4,2629,1370,3999
03/04/2018,#####,5,3079,1311,4390
03/04/2018,#####,6,3788,1381,5169
03/04/2018,#####,7,4107,1401,5508
03/04/2018,#####,8,4264,1381,5645
03/04/2018,#####,9,4000,1345,5345
03/04/2018,#####,10,3410,1325,4735
03/04/2018,#####,11,3470,1275,4745
03/04/2018,#####,12,3170,1308,4478
03/04/2018,#####,13,3045,1326,4371
03/04/2018,#####,14,3144,1225,4369
03/04/2018,#####,15,3124,1141,4265
03/04/2018,#####,16,3282,1117,4399
03/04/2018,#####,17,3560,1157,4717
03/04/2018,#####,18,3727,1264,4991
03/04/2018,#####,19,3774,1268,5042
03/04/2018,#####,20,3539,1308,4847
03/04/2018,#####,21,3315,1298,4613
03/04/2018,#####,22,3038,1282,4320
03/04/2018,#####,23,2972,1340,4312
04/04/2018,#####,0,2527,1261,3788
04/04/2018,#####,1,2580,1385,3965
04/04/2018,#####,2,2450,1350,3800
04/04/2018,#####,3,2090,1286,3376
04/04/2018,#####,4,2094,1407,3501
04/04/2018,#####,5,2326,1396,3722
04/04/2018,#####,6,3098,1531,4629
04/04/2018,#####,7,3478,1679,5157
04/04/2018,#####,8,3662,1793,5455
04/04/2018,#####,9,3424,1772,5196
04/04/2018,#####,10,3287,1636,4923
04/04/2018,#####,11,3185,1548,4733
04/04/2018,#####,12,2843,1496,4339
04/04/2018,#####,13,2622,1334,3956
04/04/2018,#####,14,2475,1296,3771
04/04/2018,#####,15,2395,1189,3584
04/04/2018,#####,16,2450,1182,3632
04/04/2018,#####,17,2532,1097,3629
04/04/2018,#####,18,2517,1031,3548
04/04/2018,#####,19,2399,1000,3399
04/04/2018,#####,20,2411,1103,3514
04/04/2018,#####,21,2384,1285,3669
04/04/2018,#####,22,2352,1401,3753
04/04/2018,#####,23,2167,1416,3583
05/04/2018,#####,0,2252,1152,3404
05/04/2018,#####,1,2026,1163,3189
05/04/2018,#####,2,1974,1321,3295
05/04/2018,#####,3,2140,1340,3480
05/04/2018,#####,4,2159,1203,3362
05/04/2018,#####,5,2527,1285,3812
05/04/2018,#####,6,2697,1297,3994
05/04/2018,#####,7,2772,1310,4082
05/04/2018,#####,8,2669,1343,4012
05/04/2018,#####,9,2724,1322,4046
05/04/2018,#####,10,2712,1383,4095
05/04/2018,#####,11,2730,1424,4154
05/04/2018,#####,12,2922,1586,4508
05/04/2018,#####,13,3147,1560,4707
05/04/2018,#####,14,3541,1324,4865
05/04/2018,#####,15,3978,1374,5352
05/04/2018,#####,16,4366,1563,5929
05/04/2018,#####,17,4770,1637,6407
05/04/2018,#####,18,4589,1704,6293
05/04/2018,#####,19,4988,1783,6771
05/04/2018,#####,20,5194,1861,7055
05/04/2018,#####,21,4956,1845,6801
05/04/2018,#####,22,4866,1774,6640
05/04/2018,#####,23,4466,1631,6097
06/04/2018,#####,0,4306,1588,5894
06/04/2018,#####,1,4211,1639,5850
06/04/2018,#####,2,4069,1604,5673
06/04/2018,#####,3,4001,1583,5584
06/04/2018,#####,4,3845,1561,5406
06/04/2018,#####,5,4092,1646,5738
06/04/2018,#####,6,4192,1794,5986
06/04/2018,#####,7,4155,1876,6031
06/04/2018,#####,8,3856,1862,5718
06/04/2018,#####,9,3691,1871,5562
06/04/2018,#####,10,3528,1784,5312
06/04/2018,#####,11,3208,1744,4952
06/04/2018,#####,12,2988,1637,4625
06/04/2018,#####,13,2870,1604,4474
06/04/2018,#####,14,2546,1473,4019
06/04/2018,#####,15,2327,1336,3663
06/04/2018,#####,16,2148,1223,3371
06/04/2018,#####,17,1918,1109,3027
06/04/2018,#####,18,1830,968,2798
06/04/2018,#####,19,1828,892,2720
06/04/2018,#####,20,2010,913,2923
06/04/2018,#####,21,2217,955,3172
06/04/2018,#####,22,2462,1016,3478
06/04/2018,#####,23,2259,1028,3287
07/04/2018,#####,0,2429,1099,3528
07/04/2018,#####,1,2632,1205,3837
07/04/2018,#####,2,2709,1139,3848
07/04/2018,#####,3,2670,1162,3832
07/04/2018,#####,4,2905,1245,4150
07/04/2018,#####,5,3101,1227,4328
07/04/2018,#####,6,3096,1220,4316
07/04/2018,#####,7,3062,1261,4323
07/04/2018,#####,8,2912,1342,4254
07/04/2018,#####,9,2823,1396,4219
07/04/2018,#####,10,2703,1406,4109
07/04/2018,#####,11,2505,1386,3891
07/04/2018,#####,12,2477,1381,3858
07/04/2018,#####,13,2351,1387,3738
07/04/2018,#####,14,2131,1376,3507
07/04/2018,#####,15,1974,1425,3399
07/04/2018,#####,16,1792,1281,3073
07/04/2018,#####,17,2060,1257,3317
07/04/2018,#####,18,2048,1253,3301
07/04/2018,#####,19,2097,1207,3304
07/04/2018,#####,20,2076,1199,3275
07/04/2018,#####,21,2137,1176,3313
07/04/2018,#####,22,1987,1099,3086
07/04/2018,#####,23,1832,1101,2933
08/04/2018,#####,0,1462,1058,2520
08/04/2018,#####,1,1312,976,2288
08/04/2018,#####,2,1357,936,2293
08/04/2018,#####,3,1372,987,2359
08/04/2018,#####,4,1447,1077,2524
08/04/2018,#####,5,1562,1093,2655
08/04/2018,#####,6,1737,1056,2793
08/04/2018,#####,7,1764,1026,2790
08/04/2018,#####,8,1802,1116,2918
08/04/2018,#####,9,1674,1177,2851
08/04/2018,#####,10,1738,1214,2952
08/04/2018,#####,11,1702,1248,2950
08/04/2018,#####,12,1726,1252,2978
08/04/2018,#####,13,1732,1113,2845
08/04/2018,#####,14,1740,1171,2911
08/04/2018,#####,15,1922,1122,3044
08/04/2018,#####,16,1873,1076,2949
08/04/2018,#####,17,1897,1017,2914
08/04/2018,#####,18,1920,991,2911
08/04/2018,#####,19,1890,1025,2915
08/04/2018,#####,20,1986,1083,3069
08/04/2018,#####,21,1897,1087,2984
08/04/2018,#####,22,1671,1059,2730
08/04/2018,#####,23,1331,968,2299
09/04/2018,#####,0,1167,862,2029
09/04/2018,#####,1,1314,779,2093
09/04/2018,#####,2,1258,765,2023
09/04/2018,#####,3,1147,731,1878
09/04/2018,#####,4,1185,726,1911
09/04/2018,#####,5,1329,785,2114
09/04/2018,#####,6,1925,903,2828
09/04/2018,#####,7,2130,1076,3206
09/04/2018,#####,8,2116,1293,3409
09/04/2018,#####,9,2101,1345,3446
09/04/2018,#####,10,2135,1379,3514
09/04/2018,#####,11,2201,1340,3541
09/04/2018,#####,12,2099,1309,3408
09/04/2018,#####,13,2122,1279,3401
09/04/2018,#####,14,2125,1306,3431
09/04/2018,#####,15,2200,1288,3488
09/04/2018,#####,16,2255,1249,3504
09/04/2018,#####,17,2376,1269,3645
09/04/2018,#####,18,2441,1263,3704
09/04/2018,#####,19,2450,1246,3696
09/04/2018,#####,20,2469,1136,3605
09/04/2018,#####,21,2172,1007,3179
09/04/2018,#####,22,2145,1040,3185
09/04/2018,#####,23,1862,997,2859
10/04/2018,#####,0,1988,1029,3017
10/04/2018,#####,1,2023,951,2974
10/04/2018,#####,2,2313,941,3254
10/04/2018,#####,3,2507,998,3505
10/04/2018,#####,4,2883,1007,3890
10/04/2018,#####,5,3355,1083,4438
10/04/2018,#####,6,3943,1374,5317
10/04/2018,#####,7,4188,1529,5717
10/04/2018,#####,8,3601,1591,5192
10/04/2018,#####,9,2887,1863,4750
10/04/2018,#####,10,2941,1826,4767
10/04/2018,#####,11,2838,1718,4556
10/04/2018,#####,12,3576,1857,5433
10/04/2018,#####,13,3819,1875,5694
10/04/2018,#####,14,3712,1705,5417
10/04/2018,#####,15,3757,1653,5410
10/04/2018,#####,16,4034,1721,5755
10/04/2018,#####,17,4125,1872,5997
10/04/2018,#####,18,4240,1810,6050
10/04/2018,#####,19,4139,1721,5860
10/04/2018,#####,20,4019,1641,5660
10/04/2018,#####,21,3776,1561,5337
10/04/2018,#####,22,3477,1561,5038
10/04/2018,#####,23,3399,1466,4865
11/04/2018,#####,0,3430,1465,4895
11/04/2018,#####,1,3481,1433,4914
11/04/2018,#####,2,3652,1408,5060
11/04/2018,#####,3,3504,1401,4905
11/04/2018,#####,4,3558,1386,4944
11/04/2018,#####,5,3656,1371,5027
11/04/2018,#####,6,3937,1407,5344
11/04/2018,#####,7,4307,1478,5785
11/04/2018,#####,8,4196,1630,5826
11/04/2018,#####,9,4159,1790,5949
11/04/2018,#####,10,4247,1816,6063
11/04/2018,#####,11,4114,1737,5851
11/04/2018,#####,12,3819,1722,5541
11/04/2018,#####,13,3965,1738,5703
11/04/2018,#####,14,3903,1671,5574
11/04/2018,#####,15,3805,1652,5457
11/04/2018,#####,16,3904,1649,5553
11/04/2018,#####,17,3983,1645,5628
11/04/2018,#####,18,3752,1597,5349
11/04/2018,#####,19,3668,1524,5192
11/04/2018,#####,20,3649,1517,5166
11/04/2018,#####,21,3710,1572,5282
11/04/2018,#####,22,3456,1482,4938
11/04/2018,#####,23,3185,1428,4613
12/04/2018,#####,0,2999,1362,4361
12/04/2018,#####,1,3025,1334,4359
12/04/2018,#####,2,3151,1315,4466
12/04/2018,#####,3,3264,1293,4557
12/04/2018,#####,4,3266,1268,4534
12/04/2018,#####,5,3409,1337,4746
12/04/2018,#####,6,3797,1468,5265
12/04/2018,#####,7,3955,1437,5392
12/04/2018,#####,8,4173,1554,5727
12/04/2018,#####,9,4017,1621,5638
12/04/2018,#####,10,4111,1612,5723
12/04/2018,#####,11,4151,1700,5851
12/04/2018,#####,12,4235,1684,5919
12/04/2018,#####,13,4285,1714,5999
12/04/2018,#####,14,4338,1727,6065
12/04/2018,#####,15,4386,1689,6075
12/04/2018,#####,16,4402,1635,6037
12/04/2018,#####,17,4460,1594,6054
12/04/2018,#####,18,4521,1569,6090
12/04/2018,#####,19,3951,1599,5550
12/04/2018,#####,20,4073,1525,5598
12/04/2018,#####,21,4390,1592,5982
12/04/2018,#####,22,4309,1544,5853
12/04/2018,#####,23,4019,1496,5515
13/04/2018,#####,0,3923,1442,5365
13/04/2018,#####,1,3805,1462,5267
13/04/2018,#####,2,3763,1444,5207
13/04/2018,#####,3,3909,1438,5347
13/04/2018,#####,4,4034,1447,5481
13/04/2018,#####,5,4241,1478,5719
13/04/2018,#####,6,4485,1641,6126
13/04/2018,#####,7,4615,1747,6362
13/04/2018,#####,8,4560,1798,6358
13/04/2018,#####,9,4559,1819,6378
13/04/2018,#####,10,4624,1768,6392
13/04/2018,#####,11,4525,1791,6316
13/04/2018,#####,12,4464,1835,6299
13/04/2018,#####,13,4237,1893,6130
13/04/2018,#####,14,4085,1897,5982
13/04/2018,#####,15,4018,1848,5866
13/04/2018,#####,16,3904,1736,5640
13/04/2018,#####,17,3570,1692,5262
13/04/2018,#####,18,3307,1665,4972
13/04/2018,#####,19,3138,1567,4705
13/04/2018,#####,20,3108,1462,4570
13/04/2018,#####,21,3060,1406,4466
13/04/2018,#####,22,2898,1318,4216
13/04/2018,#####,23,2487,1244,3731
14/04/2018,#####,0,1992,1049,3041
14/04/2018,#####,1,1858,943,2801
14/04/2018,#####,2,1844,870,2714
14/04/2018,#####,3,1921,881,2802
14/04/2018,#####,4,1859,859,2718
14/04/2018,#####,5,1841,779,2620
14/04/2018,#####,6,1925,788,2713
14/04/2018,#####,7,2313,778,3091
14/04/2018,#####,8,2383,821,3204
14/04/2018,#####,9,2449,861,3310
14/04/2018,#####,10,2402,939,3341
14/04/2018,#####,11,2311,909,3220
14/04/2018,#####,12,2166,853,3019
14/04/2018,#####,13,2057,925,2982
14/04/2018,#####,14,1857,923,2780
14/04/2018,#####,15,1692,917,2609
14/04/2018,#####,16,1624,936,2560
14/04/2018,#####,17,1355,970,2325
14/04/2018,#####,18,1843,1035,2878
14/04/2018,#####,19,1911,1076,2987
14/04/2018,#####,20,1860,1023,2883
14/04/2018,#####,21,1850,1134,2984
14/04/2018,#####,22,1608,1053,2661
14/04/2018,#####,23,1509,1124,2633
15/04/2018,#####,0,1119,1015,2134
15/04/2018,#####,1,1024,996,2020
15/04/2018,#####,2,1012,1017,2029
15/04/2018,#####,3,1024,1030,2054
15/04/2018,#####,4,1056,919,1975
15/04/2018,#####,5,1085,967,2052
15/04/2018,#####,6,1210,950,2160
15/04/2018,#####,7,1350,932,2282
15/04/2018,#####,8,1445,898,2343
15/04/2018,#####,9,1501,898,2399
15/04/2018,#####,10,1560,886,2446
15/04/2018,#####,11,1611,930,2541
15/04/2018,#####,12,1600,955,2555
15/04/2018,#####,13,1619,960,2579
15/04/2018,#####,14,1488,956,2444
15/04/2018,#####,15,1582,977,2559
15/04/2018,#####,16,1739,975,2714
15/04/2018,#####,17,1668,991,2659
15/04/2018,#####,18,1608,948,2556
15/04/2018,#####,19,1896,937,2833
15/04/2018,#####,20,1949,963,2912
15/04/2018,#####,21,1757,877,2634
15/04/2018,#####,22,1544,817,2361
15/04/2018,#####,23,1435,721,2156
16/04/2018,#####,0,1367,668,2035
16/04/2018,#####,1,1244,684,1928
16/04/2018,#####,2,1152,705,1857
16/04/2018,#####,3,1262,706,1968
16/04/2018,#####,4,1161,766,1927
16/04/2018,#####,5,1246,843,2089
16/04/2018,#####,6,1966,936,2902
16/04/2018,#####,7,2237,1139,3376
16/04/2018,#####,8,2333,1357,3690
16/04/2018,#####,9,2156,1359,3515
16/04/2018,#####,10,2196,1463,3659
16/04/2018,#####,11,2317,1423,3740
16/04/2018,#####,12,2224,1418,3642
16/04/2018,#####,13,2218,1379,3597
16/04/2018,#####,14,2056,1301,3357
16/04/2018,#####,15,2101,1258,3359
16/04/2018,#####,16,1872,1221,3093
16/04/2018,#####,17,1802,1261,3063
16/04/2018,#####,18,1775,1218,2993
16/04/2018,#####,19,1740,1167,2907
16/04/2018,#####,20,1649,1169,2818
16/04/2018,#####,21,1581,1172,2753
16/04/2018,#####,22,1514,1074,2588
16/04/2018,#####,23,1457,982,2439
17/04/2018,#####,0,1061,913,1974
17/04/2018,#####,1,1033,864,1897
17/04/2018,#####,2,1018,901,1919
17/04/2018,#####,3,983,889,1872
17/04/2018,#####,4,926,834,1760
17/04/2018,#####,5,1004,844,1848
17/04/2018,#####,6,1382,1009,2391
17/04/2018,#####,7,1430,1175,2605
17/04/2018,#####,8,1537,1189,2726
17/04/2018,#####,9,1769,1163,2932
17/04/2018,#####,10,1819,1185,3004
17/04/2018,#####,11,2027,1207,3234
17/04/2018,#####,12,2001,1253,3254
17/04/2018,#####,13,2246,1322,3568
17/04/2018,#####,14,2171,1305,3476
17/04/2018,#####,15,2243,1286,3529
17/04/2018,#####,16,2182,1189,3371
17/04/2018,#####,17,2269,1135,3404
17/04/2018,#####,18,2241,1216,3457
17/04/2018,#####,19,2233,1107,3340
17/04/2018,#####,20,2276,1007,3283
17/04/2018,#####,21,2401,967,3368
17/04/2018,#####,22,2601,961,3562
17/04/2018,#####,23,2700,802,3502
18/04/2018,#####,0,2554,754,3308
18/04/2018,#####,1,2534,743,3277
18/04/2018,#####,2,2660,810,3470
18/04/2018,#####,3,2896,870,3766
18/04/2018,#####,4,2677,856,3533
18/04/2018,#####,5,2448,1006,3454
18/04/2018,#####,6,2764,1044,3808
18/04/2018,#####,7,2703,1174,3877
18/04/2018,#####,8,2687,1272,3959
18/04/2018,#####,9,2488,1152,3640
18/04/2018,#####,10,2425,1129,3554
18/04/2018,#####,11,2387,1167,3554
18/04/2018,#####,12,2344,1131,3475
18/04/2018,#####,13,2502,1134,3636
18/04/2018,#####,14,2529,1167,3696
18/04/2018,#####,15,2124,1030,3154
18/04/2018,#####,16,1834,1031,2865
18/04/2018,#####,17,2105,1100,3205
18/04/2018,#####,18,1926,996,2922
18/04/2018,#####,19,1717,838,2555
18/04/2018,#####,20,1512,812,2324
18/04/2018,#####,21,1423,776,2199
18/04/2018,#####,22,1313,757,2070
18/04/2018,#####,23,837,652,1489
19/04/2018,#####,0,619,496,1115
19/04/2018,#####,1,590,419,1009
19/04/2018,#####,2,591,455,1046
19/04/2018,#####,3,574,458,1032
19/04/2018,#####,4,560,449,1009
19/04/2018,#####,5,664,450,1114
19/04/2018,#####,6,1159,616,1775
19/04/2018,#####,7,1323,685,2008
19/04/2018,#####,8,1444,762,2206
19/04/2018,#####,9,1666,806,2472
19/04/2018,#####,10,1907,843,2750
19/04/2018,#####,11,2063,876,2939
19/04/2018,#####,12,2241,836,3077
19/04/2018,#####,13,2170,824,2994
19/04/2018,#####,14,2251,877,3128
19/04/2018,#####,15,2001,838,2839
19/04/2018,#####,16,2184,767,2951
19/04/2018,#####,17,2185,813,2998
19/04/2018,#####,18,2117,814,2931
19/04/2018,#####,19,2059,796,2855
19/04/2018,#####,20,2058,747,2805
19/04/2018,#####,21,2300,818,3118
19/04/2018,#####,22,2463,814,3277
19/04/2018,#####,23,1988,788,2776
20/04/2018,#####,0,1807,707,2514
20/04/2018,#####,1,1760,694,2454
20/04/2018,#####,2,1760,671,2431
20/04/2018,#####,3,1764,671,2435
20/04/2018,#####,4,1760,683,2443
20/04/2018,#####,5,1831,718,2549
20/04/2018,#####,6,2442,804,3246
20/04/2018,#####,7,2656,945,3601
20/04/2018,#####,8,2607,1099,3706
20/04/2018,#####,9,2619,1318,3937
20/04/2018,#####,10,2635,1353,3988
20/04/2018,#####,11,2606,1216,3822
20/04/2018,#####,12,2562,1144,3706
20/04/2018,#####,13,2149,1146,3295
20/04/2018,#####,14,2250,1103,3353
20/04/2018,#####,15,2421,1175,3596
20/04/2018,#####,16,2585,1102,3687
20/04/2018,#####,17,2738,1136,3874
20/04/2018,#####,18,2585,1240,3825
20/04/2018,#####,19,2444,1164,3608
20/04/2018,#####,20,2396,1115,3511
20/04/2018,#####,21,2491,1007,3498
20/04/2018,#####,22,2254,901,3155
20/04/2018,#####,23,2030,840,2870
21/04/2018,#####,0,1882,774,2656
21/04/2018,#####,1,1793,738,2531
21/04/2018,#####,2,1780,739,2519
21/04/2018,#####,3,1767,619,2386
21/04/2018,#####,4,1777,568,2345
21/04/2018,#####,5,1784,535,2319
21/04/2018,#####,6,1817,502,2319
21/04/2018,#####,7,1681,538,2219
21/04/2018,#####,8,1745,593,2338
21/04/2018,#####,9,1869,612,2481
21/04/2018,#####,10,2151,675,2826
21/04/2018,#####,11,2215,723,2938
21/04/2018,#####,12,2322,766,3088
21/04/2018,#####,13,2449,797,3246
21/04/2018,#####,14,2406,798,3204
21/04/2018,#####,15,2312,793,3105
21/04/2018,#####,16,2216,777,2993
21/04/2018,#####,17,2096,737,2833
21/04/2018,#####,18,2187,613,2800
21/04/2018,#####,19,1916,543,2459
21/04/2018,#####,20,1715,535,2250
21/04/2018,#####,21,1655,548,2203
21/04/2018,#####,22,1473,520,1993
21/04/2018,#####,23,1188,542,1730
22/04/2018,#####,0,954,548,1502
22/04/2018,#####,1,909,546,1455
22/04/2018,#####,2,877,526,1403
22/04/2018,#####,3,851,514,1365
22/04/2018,#####,4,769,506,1275
22/04/2018,#####,5,659,491,1150
22/04/2018,#####,6,642,518,1160
22/04/2018,#####,7,689,522,1211
22/04/2018,#####,8,781,550,1331
22/04/2018,#####,9,884,647,1531
22/04/2018,#####,10,947,719,1666
22/04/2018,#####,11,1061,763,1824
22/04/2018,#####,12,1053,791,1844
22/04/2018,#####,13,1115,790,1905
22/04/2018,#####,14,1179,769,1948
22/04/2018,#####,15,1245,762,2007
22/04/2018,#####,16,1325,775,2100
22/04/2018,#####,17,1309,791,2100
22/04/2018,#####,18,1351,801,2152
22/04/2018,#####,19,1489,791,2280
22/04/2018,#####,20,1719,765,2484
22/04/2018,#####,21,1910,853,2763
22/04/2018,#####,22,2098,958,3056
22/04/2018,#####,23,2126,1008,3134
23/04/2018,#####,0,2254,984,3238
23/04/2018,#####,1,2248,762,3010
23/04/2018,#####,2,1997,643,2640
23/04/2018,#####,3,1702,545,2247
23/04/2018,#####,4,1535,641,2176
23/04/2018,#####,5,1681,890,2571
23/04/2018,#####,6,2190,1136,3326
23/04/2018,#####,7,3060,1063,4123
23/04/2018,#####,8,3100,1038,4138
23/04/2018,#####,9,3140,1122,4262
23/04/2018,#####,10,3342,1224,4566
23/04/2018,#####,11,3777,1379,5156
23/04/2018,#####,12,3992,1449,5441
23/04/2018,#####,13,3925,1336,5261
23/04/2018,#####,14,3969,1432,5401
23/04/2018,#####,15,3702,1462,5164
23/04/2018,#####,16,3776,1479,5255
23/04/2018,#####,17,4382,1390,5772
23/04/2018,#####,18,4422,1303,5725
23/04/2018,#####,19,3976,1253,5229
23/04/2018,#####,20,3522,1173,4695
23/04/2018,#####,21,3371,1126,4497
23/04/2018,#####,22,3148,1130,4278
23/04/2018,#####,23,2895,1083,3978
24/04/2018,#####,0,2270,1022,3292
24/04/2018,#####,1,1975,926,2901
24/04/2018,#####,2,2016,876,2892
24/04/2018,#####,3,2027,938,2965
24/04/2018,#####,4,2016,965,2981
24/04/2018,#####,5,2309,1062,3371
24/04/2018,#####,6,2493,1113,3606
24/04/2018,#####,7,2900,1184,4084
24/04/2018,#####,8,3354,1346,4700
24/04/2018,#####,9,3378,1368,4746
24/04/2018,#####,10,3516,1382,4898
24/04/2018,#####,11,3904,1381,5285
24/04/2018,#####,12,4137,1418,5555
24/04/2018,#####,13,4280,1465,5745
24/04/2018,#####,14,4328,1540,5868
24/04/2018,#####,15,4255,1533,5788
24/04/2018,#####,16,4126,1464,5590
24/04/2018,#####,17,3944,1349,5293
24/04/2018,#####,18,3748,1342,5090
24/04/2018,#####,19,3361,1344,4705
24/04/2018,#####,20,3035,1273,4308
24/04/2018,#####,21,2767,1130,3897
24/04/2018,#####,22,2477,1091,3568
24/04/2018,#####,23,2107,895,3002
25/04/2018,#####,0,1966,689,2655
25/04/2018,#####,1,1692,576,2268
25/04/2018,#####,2,1524,551,2075
25/04/2018,#####,3,1238,547,1785
25/04/2018,#####,4,1118,499,1617
25/04/2018,#####,5,1108,522,1630
25/04/2018,#####,6,1327,599,1926
25/04/2018,#####,7,1586,861,2447
25/04/2018,#####,8,1671,1222,2893
25/04/2018,#####,9,1820,1225,3045
25/04/2018,#####,10,1898,1171,3069
25/04/2018,#####,11,2208,1124,3332
25/04/2018,#####,12,2633,1139,3772
25/04/2018,#####,13,2798,1180,3978
25/04/2018,#####,14,2865,1122,3987
25/04/2018,#####,15,2818,1071,3889
25/04/2018,#####,16,2865,1151,4016
25/04/2018,#####,17,2514,1187,3701
25/04/2018,#####,18,2708,1205,3913
25/04/2018,#####,19,3040,1141,4181
25/04/2018,#####,20,2843,1012,3855
25/04/2018,#####,21,2577,909,3486
25/04/2018,#####,22,2154,784,2938
25/04/2018,#####,23,1882,876,2758
26/04/2018,#####,0,1768,930,2698
26/04/2018,#####,1,1584,935,2519
26/04/2018,#####,2,1472,943,2415
26/04/2018,#####,3,1407,903,2310
26/04/2018,#####,4,1328,794,2122
26/04/2018,#####,5,1362,751,2113
26/04/2018,#####,6,1534,865,2399
26/04/2018,#####,7,1859,1048,2907
26/04/2018,#####,8,1978,1128,3106
26/04/2018,#####,9,2083,1133,3216
26/04/2018,#####,10,2119,1064,3183
26/04/2018,#####,11,2285,1058,3343
26/04/2018,#####,12,2664,1033,3697
26/04/2018,#####,13,2847,1151,3998
26/04/2018,#####,14,3023,1083,4106
26/04/2018,#####,15,3188,1192,4380
26/04/2018,#####,16,3168,1377,4545
26/04/2018,#####,17,3021,1425,4446
26/04/2018,#####,18,2911,1432,4343
26/04/2018,#####,19,3420,1515,4935
26/04/2018,#####,20,3284,1415,4699
26/04/2018,#####,21,3059,1280,4339
26/04/2018,#####,22,2839,1258,4097
26/04/2018,#####,23,2503,1116,3619
27/04/2018,#####,0,2446,1057,3503
27/04/2018,#####,1,2448,1140,3588
27/04/2018,#####,2,2280,1188,3468
27/04/2018,#####,3,2210,1209,3419
27/04/2018,#####,4,2083,1211,3294
27/04/2018,#####,5,2110,1152,3262
27/04/2018,#####,6,2370,1230,3600
27/04/2018,#####,7,2291,1250,3541
27/04/2018,#####,8,2348,1377,3725
27/04/2018,#####,9,2399,1401,3800
27/04/2018,#####,10,2377,1314,3691
27/04/2018,#####,11,2309,1298,3607
27/04/2018,#####,12,2031,1216,3247
27/04/2018,#####,13,1881,1055,2936
27/04/2018,#####,14,1878,985,2863
27/04/2018,#####,15,1753,904,2657
27/04/2018,#####,16,1676,806,2482
27/04/2018,#####,17,1606,719,2325
27/04/2018,#####,18,1496,792,2288
27/04/2018,#####,19,1431,775,2206
27/04/2018,#####,20,1259,782,2041
27/04/2018,#####,21,1212,824,2036
27/04/2018,#####,22,998,700,1698
27/04/2018,#####,23,518,596,1114
28/04/2018,#####,0,606,607,1213
28/04/2018,#####,1,582,606,1188
28/04/2018,#####,2,611,626,1237
28/04/2018,#####,3,633,596,1229
28/04/2018,#####,4,597,546,1143
28/04/2018,#####,5,659,536,1195
28/04/2018,#####,6,654,538,1192
28/04/2018,#####,7,720,568,1288
28/04/2018,#####,8,900,638,1538
28/04/2018,#####,9,1081,724,1805
28/04/2018,#####,10,1047,805,1852
28/04/2018,#####,11,1006,867,1873
28/04/2018,#####,12,1032,889,1921
28/04/2018,#####,13,1090,935,2025
28/04/2018,#####,14,1150,888,2038
28/04/2018,#####,15,1313,818,2131
28/04/2018,#####,16,1409,756,2165
28/04/2018,#####,17,1396,759,2155
28/04/2018,#####,18,1642,723,2365
28/04/2018,#####,19,2007,695,2702
28/04/2018,#####,20,1873,709,2582
28/04/2018,#####,21,1803,699,2502
28/04/2018,#####,22,1633,700,2333
28/04/2018,#####,23,1313,664,1977
29/04/2018,#####,0,969,543,1512
29/04/2018,#####,1,880,513,1393
29/04/2018,#####,2,756,525,1281
29/04/2018,#####,3,744,518,1262
29/04/2018,#####,4,708,486,1194
29/04/2018,#####,5,595,493,1088
29/04/2018,#####,6,607,492,1099
29/04/2018,#####,7,652,539,1191
29/04/2018,#####,8,731,606,1337
29/04/2018,#####,9,845,666,1511
29/04/2018,#####,10,934,694,1628
29/04/2018,#####,11,1037,747,1784
29/04/2018,#####,12,1087,799,1886
29/04/2018,#####,13,1053,847,1900
29/04/2018,#####,14,1095,808,1903
29/04/2018,#####,15,1048,812,1860
29/04/2018,#####,16,1103,746,1849
29/04/2018,#####,17,1045,732,1777
29/04/2018,#####,18,1055,772,1827
29/04/2018,#####,19,1095,779,1874
29/04/2018,#####,20,1047,820,1867
29/04/2018,#####,21,1024,898,1922
29/04/2018,#####,22,1122,959,2081
29/04/2018,#####,23,1017,953,1970
30/04/2018,#####,0,978,1019,1997
30/04/2018,#####,1,1155,1002,2157
30/04/2018,#####,2,1408,1036,2444
30/04/2018,#####,3,1551,1027,2578
30/04/2018,#####,4,1930,1073,3003
30/04/2018,#####,5,2225,1155,3380
30/04/2018,#####,6,2553,1256,3809
30/04/2018,#####,7,2914,1358,4272
30/04/2018,#####,8,3287,1389,4676
30/04/2018,#####,9,3370,1456,4826
30/04/2018,#####,10,3294,1527,4821
30/04/2018,#####,11,3317,1618,4935
30/04/2018,#####,12,3433,1455,4888
30/04/2018,#####,13,3491,1282,4773
30/04/2018,#####,14,3178,1021,4199
30/04/2018,#####,15,2765,837,3602
30/04/2018,#####,16,2753,756,3509
30/04/2018,#####,17,2441,813,3254
30/04/2018,#####,18,2066,771,2837
30/04/2018,#####,19,2015,641,2656
30/04/2018,#####,20,1842,632,2474
30/04/2018,#####,21,1696,616,2312
30/04/2018,#####,22,1609,734,2343
30/04/2018,#####,23,1543,735,2278
01/05/2018,#####,0,1386,744,2130
01/05/2018,#####,1,1138,782,1920
01/05/2018,#####,2,982,848,1830
01/05/2018,#####,3,978,777,1755
01/05/2018,#####,4,1019,980,1999
01/05/2018,#####,5,1061,961,2022
01/05/2018,#####,6,1155,991,2146
01/05/2018,#####,7,1293,1129,2422
01/05/2018,#####,8,1249,1275,2524
01/05/2018,#####,9,1282,1380,2662
01/05/2018,#####,10,1444,1467,2911
01/05/2018,#####,11,1578,1488,3066
01/05/2018,#####,12,1518,1526,3044
01/05/2018,#####,13,1501,1512,3013
01/05/2018,#####,14,1517,1495,3012
01/05/2018,#####,15,1656,1489,3145
01/05/2018,#####,16,1887,1511,3398
01/05/2018,#####,17,2053,1533,3586
01/05/2018,#####,18,2221,1585,3806
01/05/2018,#####,19,2410,1542,3952
01/05/2018,#####,20,2336,1499,3835
01/05/2018,#####,21,2356,1484,3840
01/05/2018,#####,22,2473,1421,3894
01/05/2018,#####,23,2344,1367,3711
02/05/2018,#####,0,2064,1304,3368
02/05/2018,#####,1,1895,1251,3146
02/05/2018,#####,2,1747,1096,2843
02/05/2018,#####,3,1691,973,2664
02/05/2018,#####,4,1661,833,2494
02/05/2018,#####,5,1707,780,2487
02/05/2018,#####,6,2093,842,2935
02/05/2018,#####,7,2208,943,3151
02/05/2018,#####,8,2370,1087,3457
02/05/2018,#####,9,2697,1102,3799
02/05/2018,#####,10,3034,1153,4187
02/05/2018,#####,11,3426,1177,4603
02/05/2018,#####,12,3463,1194,4657
02/05/2018,#####,13,3504,1222,4726
02/05/2018,#####,14,3447,1162,4609
02/05/2018,#####,15,2957,1036,3993
02/05/2018,#####,16,2888,994,3882
02/05/2018,#####,17,2717,969,3686
02/05/2018,#####,18,2909,1116,4025
02/05/2018,#####,19,2461,1186,3647
02/05/2018,#####,20,2151,1148,3299
02/05/2018,#####,21,2241,1061,3302
02/05/2018,#####,22,2526,1100,3626
02/05/2018,#####,23,2751,1009,3760
03/05/2018,#####,0,2780,857,3637
03/05/2018,#####,1,2656,762,3418
03/05/2018,#####,2,2367,699,3066
03/05/2018,#####,3,2100,695,2795
03/05/2018,#####,4,1932,665,2597
03/05/2018,#####,5,2018,700,2718
03/05/2018,#####,6,2451,772,3223
03/05/2018,#####,7,2823,926,3749
03/05/2018,#####,8,2888,1000,3888
03/05/2018,#####,9,2538,1111,3649
03/05/2018,#####,10,2594,1249,3843
03/05/2018,#####,11,2676,1220,3896
03/05/2018,#####,12,2947,1178,4125
03/05/2018,#####,13,3414,1273,4687
03/05/2018,#####,14,3431,1232,4663
03/05/2018,#####,15,3370,1129,4499
03/05/2018,#####,16,2895,1074,3969
03/05/2018,#####,17,2606,1043,3649
03/05/2018,#####,18,2492,1182,3674
03/05/2018,#####,19,2365,1278,3643
03/05/2018,#####,20,2025,1138,3163
03/05/2018,#####,21,1816,1099,2915
03/05/2018,#####,22,1518,1014,2532
03/05/2018,#####,23,1120,741,1861
04/05/2018,#####,0,1075,635,1710
04/05/2018,#####,1,1006,614,1620
04/05/2018,#####,2,970,587,1557
04/05/2018,#####,3,895,555,1450
04/05/2018,#####,4,1007,524,1531
04/05/2018,#####,5,1063,614,1677
04/05/2018,#####,6,1347,843,2190
04/05/2018,#####,7,1587,1043,2630
04/05/2018,#####,8,1531,1096,2627
04/05/2018,#####,9,1651,1070,2721
04/05/2018,#####,10,1746,1060,2806
04/05/2018,#####,11,1576,1006,2582
04/05/2018,#####,12,1575,975,2550
04/05/2018,#####,13,1604,1045,2649
04/05/2018,#####,14,1612,941,2553
04/05/2018,#####,15,1586,898,2484
04/05/2018,#####,16,1538,857,2395
04/05/2018,#####,17,1498,832,2330
04/05/2018,#####,18,1743,880,2623
04/05/2018,#####,19,1645,811,2456
04/05/2018,#####,20,1467,751,2218
04/05/2018,#####,21,1424,726,2150
04/05/2018,#####,22,1422,659,2081
04/05/2018,#####,23,1054,584,1638
05/05/2018,#####,0,849,543,1392
05/05/2018,#####,1,713,483,1196
05/05/2018,#####,2,717,498,1215
05/05/2018,#####,3,703,508,1211
05/05/2018,#####,4,708,506,1214
05/05/2018,#####,5,695,484,1179
05/05/2018,#####,6,697,495,1192
05/05/2018,#####,7,769,556,1325
05/05/2018,#####,8,904,611,1515
05/05/2018,#####,9,926,686,1612
05/05/2018,#####,10,1009,692,1701
05/05/2018,#####,11,1142,706,1848
05/05/2018,#####,12,1117,747,1864
05/05/2018,#####,13,1099,759,1858
05/05/2018,#####,14,1030,754,1784
05/05/2018,#####,15,1040,745,1785
05/05/2018,#####,16,1012,724,1736
05/05/2018,#####,17,927,695,1622
05/05/2018,#####,18,839,624,1463
05/05/2018,#####,19,724,566,1290
05/05/2018,#####,20,657,522,1179
05/05/2018,#####,21,634,528,1162
05/05/2018,#####,22,703,517,1220
05/05/2018,#####,23,641,489,1130
06/05/2018,#####,0,624,480,1104
06/05/2018,#####,1,637,486,1123
06/05/2018,#####,2,669,492,1161
06/05/2018,#####,3,649,504,1153
06/05/2018,#####,4,669,494,1163
06/05/2018,#####,5,534,453,987
06/05/2018,#####,6,510,473,983
06/05/2018,#####,7,572,521,1093
06/05/2018,#####,8,622,584,1206
06/05/2018,#####,9,742,649,1391
06/05/2018,#####,10,830,704,1534
06/05/2018,#####,11,947,712,1659
06/05/2018,#####,12,1042,717,1759
06/05/2018,#####,13,1015,723,1738
06/05/2018,#####,14,999,702,1701
06/05/2018,#####,15,964,722,1686
06/05/2018,#####,16,986,692,1678
06/05/2018,#####,17,1003,673,1676
06/05/2018,#####,18,897,618,1515
06/05/2018,#####,19,892,572,1464
06/05/2018,#####,20,843,540,1383
06/05/2018,#####,21,909,534,1443
06/05/2018,#####,22,994,572,1566
06/05/2018,#####,23,1198,603,1801
07/05/2018,#####,0,1365,602,1967
07/05/2018,#####,1,1504,572,2076
07/05/2018,#####,2,1455,574,2029
07/05/2018,#####,3,1536,593,2129
07/05/2018,#####,4,1683,606,2289
07/05/2018,#####,5,1834,604,2438
07/05/2018,#####,6,1977,630,2607
07/05/2018,#####,7,1967,656,2623
07/05/2018,#####,8,1975,821,2796
07/05/2018,#####,9,1887,844,2731
07/05/2018,#####,10,1792,934,2726
07/05/2018,#####,11,1451,850,2301
07/05/2018,#####,12,1426,837,2263
07/05/2018,#####,13,1436,838,2274
07/05/2018,#####,14,1418,803,2221
07/05/2018,#####,15,1424,749,2173
07/05/2018,#####,16,1436,749,2185
07/05/2018,#####,17,1503,783,2286
07/05/2018,#####,18,1789,852,2641
07/05/2018,#####,19,1640,916,2556
07/05/2018,#####,20,1416,849,2265
07/05/2018,#####,21,1139,703,1842
07/05/2018,#####,22,916,672,1588
07/05/2018,#####,23,911,625,1536
08/05/2018,#####,0,1093,568,1661
08/05/2018,#####,1,1134,533,1667
08/05/2018,#####,2,1078,591,1669
08/05/2018,#####,3,1166,624,1790
08/05/2018,#####,4,1205,476,1681
08/05/2018,#####,5,1358,454,1812
08/05/2018,#####,6,1330,451,1781
08/05/2018,#####,7,1403,464,1867
08/05/2018,#####,8,1317,498,1815
08/05/2018,#####,9,1408,554,1962
08/05/2018,#####,10,1538,613,2151
08/05/2018,#####,11,1777,652,2429
08/05/2018,#####,12,2021,695,2716
08/05/2018,#####,13,2183,872,3055
08/05/2018,#####,14,2433,1011,3444
08/05/2018,#####,15,2527,1076,3603
08/05/2018,#####,16,2629,1136,3765
08/05/2018,#####,17,2573,1121,3694
08/05/2018,#####,18,2485,1128,3613
08/05/2018,#####,19,2076,1040,3116
08/05/2018,#####,20,1938,989,2927
08/05/2018,#####,21,1939,960,2899
08/05/2018,#####,22,2086,939,3025
08/05/2018,#####,23,1955,901,2856
09/05/2018,#####,0,1929,697,2626
09/05/2018,#####,1,1501,627,2128
09/05/2018,#####,2,1471,569,2040
09/05/2018,#####,3,1375,540,1915
09/05/2018,#####,4,1426,521,1947
09/05/2018,#####,5,1565,626,2191
09/05/2018,#####,6,1489,759,2248
09/05/2018,#####,7,1627,769,2396
09/05/2018,#####,8,1713,852,2565
09/05/2018,#####,9,1924,1059,2983
09/05/2018,#####,10,2009,940,2949
09/05/2018,#####,11,2187,933,3120
09/05/2018,#####,12,2321,1004,3325
09/05/2018,#####,13,2498,1112,3610
09/05/2018,#####,14,3036,1262,4298
09/05/2018,#####,15,3267,1382,4649
09/05/2018,#####,16,3269,1431,4700
09/05/2018,#####,17,3004,1407,4411
09/05/2018,#####,18,2734,1236,3970
09/05/2018,#####,19,2558,1079,3637
09/05/2018,#####,20,2245,892,3137
09/05/2018,#####,21,2043,826,2869
09/05/2018,#####,22,2146,778,2924
09/05/2018,#####,23,2153,705,2858
10/05/2018,#####,0,2289,634,2923
10/05/2018,#####,1,1906,588,2494
10/05/2018,#####,2,1582,579,2161
10/05/2018,#####,3,1626,564,2190
10/05/2018,#####,4,1714,530,2244
10/05/2018,#####,5,1764,486,2250
10/05/2018,#####,6,1563,506,2069
10/05/2018,#####,7,1384,514,1898
10/05/2018,#####,8,1340,549,1889
10/05/2018,#####,9,1328,575,1903
10/05/2018,#####,10,1250,664,1914
10/05/2018,#####,11,1220,743,1963
10/05/2018,#####,12,1186,812,1998
10/05/2018,#####,13,1246,850,2096
10/05/2018,#####,14,1505,922,2427
10/05/2018,#####,15,1370,894,2264
10/05/2018,#####,16,1737,783,2520
10/05/2018,#####,17,1881,688,2569
10/05/2018,#####,18,1947,793,2740
10/05/2018,#####,19,1685,626,2311
10/05/2018,#####,20,1447,571,2018
10/05/2018,#####,21,1466,584,2050
10/05/2018,#####,22,1452,595,2047
10/05/2018,#####,23,1477,593,2070
11/05/2018,#####,0,1439,547,1986
11/05/2018,#####,1,1399,510,1909
11/05/2018,#####,2,1288,634,1922
11/05/2018,#####,3,1214,709,1923
11/05/2018,#####,4,1221,506,1727
11/05/2018,#####,5,1181,450,1631
11/05/2018,#####,6,1226,667,1893
11/05/2018,#####,7,1197,619,1816
11/05/2018,#####,8,1225,688,1913
11/05/2018,#####,9,1479,693,2172
11/05/2018,#####,10,1490,763,2253
11/05/2018,#####,11,1479,738,2217
11/05/2018,#####,12,1454,780,2234
11/05/2018,#####,13,1407,647,2054
11/05/2018,#####,14,1369,637,2006
11/05/2018,#####,15,1263,594,1857
11/05/2018,#####,16,1157,651,1808
11/05/2018,#####,17,1182,636,1818
11/05/2018,#####,18,1071,623,1694
11/05/2018,#####,19,963,578,1541
11/05/2018,#####,20,905,565,1470
11/05/2018,#####,21,806,550,1356
11/05/2018,#####,22,764,558,1322
11/05/2018,#####,23,611,537,1148
12/05/2018,#####,0,643,425,1068
12/05/2018,#####,1,636,387,1023
12/05/2018,#####,2,583,332,915
12/05/2018,#####,3,609,318,927
12/05/2018,#####,4,611,313,924
12/05/2018,#####,5,584,317,901
12/05/2018,#####,6,619,350,969
12/05/2018,#####,7,723,383,1106
12/05/2018,#####,8,823,432,1255
12/05/2018,#####,9,852,501,1353
12/05/2018,#####,10,708,542,1250
12/05/2018,#####,11,762,582,1344
12/05/2018,#####,12,845,586,1431
12/05/2018,#####,13,932,565,1497
12/05/2018,#####,14,936,531,1467
12/05/2018,#####,15,881,502,1383
12/05/2018,#####,16,886,474,1360
12/05/2018,#####,17,890,450,1340
12/05/2018,#####,18,972,437,1409
12/05/2018,#####,19,891,450,1341
12/05/2018,#####,20,788,380,1168
12/05/2018,#####,21,624,387,1011
12/05/2018,#####,22,880,464,1344
12/05/2018,#####,23,966,422,1388
13/05/2018,#####,0,902,405,1307
13/05/2018,#####,1,784,357,1141
13/05/2018,#####,2,721,344,1065
13/05/2018,#####,3,614,379,993
13/05/2018,#####,4,658,412,1070
13/05/2018,#####,5,697,460,1157
13/05/2018,#####,6,704,492,1196
13/05/2018,#####,7,811,564,1375
13/05/2018,#####,8,938,601,1539
13/05/2018,#####,9,1011,701,1712
13/05/2018,#####,10,1172,748,1920
13/05/2018,#####,11,1407,778,2185
13/05/2018,#####,12,1533,846,2379
13/05/2018,#####,13,1685,923,2608
13/05/2018,#####,14,1853,1034,2887
13/05/2018,#####,15,1974,1089,3063
13/05/2018,#####,16,2145,1116,3261
13/05/2018,#####,17,2324,1124,3448
13/05/2018,#####,18,2241,1101,3342
13/05/2018,#####,19,2055,1037,3092
13/05/2018,#####,20,1910,968,2878
13/05/2018,#####,21,1754,933,2687
13/05/2018,#####,22,1755,901,2656
13/05/2018,#####,23,1694,881,2575
14/05/2018,#####,0,1658,837,2495
14/05/2018,#####,1,1166,720,1886
14/05/2018,#####,2,1212,664,1876
14/05/2018,#####,3,1356,634,1990
14/05/2018,#####,4,1329,571,1900
14/05/2018,#####,5,1567,557,2124
14/05/2018,#####,6,993,608,1601
14/05/2018,#####,7,1075,650,1725
14/05/2018,#####,8,1153,867,2020
14/05/2018,#####,9,1421,1047,2468
14/05/2018,#####,10,1554,1093,2647
14/05/2018,#####,11,1574,1079,2653
14/05/2018,#####,12,1405,1066,2471
14/05/2018,#####,13,1482,1052,2534
14/05/2018,#####,14,1512,1045,2557
14/05/2018,#####,15,1534,1012,2546
14/05/2018,#####,16,1464,961,2425
14/05/2018,#####,17,1292,859,2151
14/05/2018,#####,18,1296,703,1999
14/05/2018,#####,19,1131,631,1762
14/05/2018,#####,20,858,521,1379
14/05/2018,#####,21,687,510,1197
14/05/2018,#####,22,756,549,1305
14/05/2018,#####,23,1089,502,1591
15/05/2018,#####,0,680,472,1152
15/05/2018,#####,1,827,486,1313
15/05/2018,#####,2,824,513,1337
15/05/2018,#####,3,764,514,1278
15/05/2018,#####,4,667,503,1170
15/05/2018,#####,5,563,483,1046
15/05/2018,#####,6,802,545,1347
15/05/2018,#####,7,1234,686,1920
15/05/2018,#####,8,1344,806,2150
15/05/2018,#####,9,1469,850,2319
15/05/2018,#####,10,1556,943,2499
15/05/2018,#####,11,1623,953,2576
15/05/2018,#####,12,1631,968,2599
15/05/2018,#####,13,1588,864,2452
15/05/2018,#####,14,1493,829,2322
15/05/2018,#####,15,1354,803,2157
15/05/2018,#####,16,1263,807,2070
15/05/2018,#####,17,1339,853,2192
15/05/2018,#####,18,1294,865,2159
15/05/2018,#####,19,1225,800,2025
15/05/2018,#####,20,1010,668,1678
15/05/2018,#####,21,962,591,1553
15/05/2018,#####,22,1062,564,1626
15/05/2018,#####,23,937,553,1490
16/05/2018,#####,0,944,477,1421
16/05/2018,#####,1,946,418,1364
16/05/2018,#####,2,939,375,1314
16/05/2018,#####,3,1008,331,1339
16/05/2018,#####,4,1075,359,1434
16/05/2018,#####,5,1227,407,1634
16/05/2018,#####,6,1555,539,2094
16/05/2018,#####,7,1557,578,2135
16/05/2018,#####,8,1886,693,2579
16/05/2018,#####,9,1639,702,2341
16/05/2018,#####,10,1671,703,2374
16/05/2018,#####,11,1789,736,2525
16/05/2018,#####,12,2199,852,3051
16/05/2018,#####,13,2205,882,3087
16/05/2018,#####,14,2423,827,3250
16/05/2018,#####,15,2687,783,3470
16/05/2018,#####,16,3000,699,3699
16/05/2018,#####,17,2843,580,3423
16/05/2018,#####,18,2323,515,2838
16/05/2018,#####,19,2009,541,2550
16/05/2018,#####,20,1673,609,2282
16/05/2018,#####,21,1576,656,2232
16/05/2018,#####,22,1367,632,1999
16/05/2018,#####,23,1218,617,1835
17/05/2018,#####,0,1066,625,1691
17/05/2018,#####,1,892,595,1487
17/05/2018,#####,2,767,576,1343
17/05/2018,#####,3,824,599,1423
17/05/2018,#####,4,721,600,1321
17/05/2018,#####,5,737,553,1290
17/05/2018,#####,6,1119,497,1616
17/05/2018,#####,7,1789,547,2336
17/05/2018,#####,8,1956,649,2605
17/05/2018,#####,9,2163,724,2887
17/05/2018,#####,10,2290,799,3089
17/05/2018,#####,11,2217,745,2962
17/05/2018,#####,12,2519,741,3260
17/05/2018,#####,13,2465,769,3234
17/05/2018,#####,14,2591,778,3369
17/05/2018,#####,15,2649,706,3355
17/05/2018,#####,16,2571,693,3264
17/05/2018,#####,17,2633,666,3299
17/05/2018,#####,18,2347,611,2958
17/05/2018,#####,19,2094,507,2601
17/05/2018,#####,20,1872,440,2312
17/05/2018,#####,21,1654,440,2094
17/05/2018,#####,22,1619,417,2036
17/05/2018,#####,23,1319,380,1699
18/05/2018,#####,0,1277,365,1642
18/05/2018,#####,1,1248,356,1604
18/05/2018,#####,2,1310,351,1661
18/05/2018,#####,3,1321,316,1637
18/05/2018,#####,4,1261,381,1642
18/05/2018,#####,5,1433,609,2042
18/05/2018,#####,6,1610,554,2164
18/05/2018,#####,7,1907,613,2520
18/05/2018,#####,8,2112,810,2922
18/05/2018,#####,9,2086,801,2887
18/05/2018,#####,10,1930,990,2920
18/05/2018,#####,11,1925,932,2857
18/05/2018,#####,12,1747,762,2509
18/05/2018,#####,13,1720,709,2429
18/05/2018,#####,14,1668,693,2361
18/05/2018,#####,15,1695,706,2401
18/05/2018,#####,16,1636,724,2360
18/05/2018,#####,17,1587,854,2441
18/05/2018,#####,18,1611,758,2369
18/05/2018,#####,19,1628,943,2571
18/05/2018,#####,20,1574,929,2503
18/05/2018,#####,21,1388,903,2291
18/05/2018,#####,22,1372,683,2055
18/05/2018,#####,23,1136,657,1793
19/05/2018,#####,0,878,568,1446
19/05/2018,#####,1,763,418,1181
19/05/2018,#####,2,763,365,1128
19/05/2018,#####,3,826,353,1179
19/05/2018,#####,4,797,355,1152
19/05/2018,#####,5,764,384,1148
19/05/2018,#####,6,731,398,1129
19/05/2018,#####,7,975,429,1404
19/05/2018,#####,8,1009,453,1462
19/05/2018,#####,9,930,528,1458
19/05/2018,#####,10,966,568,1534
19/05/2018,#####,11,1063,626,1689
19/05/2018,#####,12,1341,699,2040
19/05/2018,#####,13,1353,700,2053
19/05/2018,#####,14,1287,929,2216
19/05/2018,#####,15,1253,990,2243
19/05/2018,#####,16,1181,1013,2194
19/05/2018,#####,17,1107,723,1830
19/05/2018,#####,18,1108,563,1671
19/05/2018,#####,19,1130,512,1642
19/05/2018,#####,20,847,477,1324
19/05/2018,#####,21,727,462,1189
19/05/2018,#####,22,668,490,1158
19/05/2018,#####,23,669,495,1164
20/05/2018,#####,0,715,506,1221
20/05/2018,#####,1,711,484,1195
20/05/2018,#####,2,692,440,1132
20/05/2018,#####,3,670,415,1085
20/05/2018,#####,4,620,380,1000
20/05/2018,#####,5,676,390,1066
20/05/2018,#####,6,731,414,1145
20/05/2018,#####,7,835,442,1277
20/05/2018,#####,8,927,519,1446
20/05/2018,#####,9,1095,591,1686
20/05/2018,#####,10,1262,607,1869
20/05/2018,#####,11,1282,615,1897
20/05/2018,#####,12,1374,624,1998
20/05/2018,#####,13,1363,606,1969
20/05/2018,#####,14,1395,616,2011
20/05/2018,#####,15,1321,646,1967
20/05/2018,#####,16,1311,662,1973
20/05/2018,#####,17,1316,675,1991
20/05/2018,#####,18,1283,656,1939
20/05/2018,#####,19,1261,586,1847
20/05/2018,#####,20,1140,558,1698
20/05/2018,#####,21,1092,556,1648
20/05/2018,#####,22,1094,631,1725
20/05/2018,#####,23,1091,604,1695
21/05/2018,#####,0,1135,554,1689
21/05/2018,#####,1,1260,514,1774
21/05/2018,#####,2,1313,496,1809
21/05/2018,#####,3,1194,506,1700
21/05/2018,#####,4,1173,552,1725
21/05/2018,#####,5,1207,565,1772
21/05/2018,#####,6,1255,601,1856
21/05/2018,#####,7,1233,671,1904
21/05/2018,#####,8,1322,631,1953
21/05/2018,#####,9,1385,734,2119
21/05/2018,#####,10,1504,847,2351
21/05/2018,#####,11,1683,925,2608
21/05/2018,#####,12,1750,1073,2823
21/05/2018,#####,13,1928,1163,3091
21/05/2018,#####,14,1983,1330,3313
21/05/2018,#####,15,1969,1308,3277
21/05/2018,#####,16,1918,1208,3126
21/05/2018,#####,17,2010,1150,3160
21/05/2018,#####,18,2018,1051,3069
21/05/2018,#####,19,1961,1018,2979
21/05/2018,#####,20,1703,1025,2728
21/05/2018,#####,21,1454,928,2382
21/05/2018,#####,22,1400,823,2223
21/05/2018,#####,23,1306,764,2070
22/05/2018,#####,0,1330,730,2060
22/05/2018,#####,1,1316,739,2055
22/05/2018,#####,2,1278,684,1962
22/05/2018,#####,3,1348,617,1965
22/05/2018,#####,4,1396,566,1962
22/05/2018,#####,5,1409,526,1935
22/05/2018,#####,6,1560,611,2171
22/05/2018,#####,7,1319,894,2213
22/05/2018,#####,8,1570,1025,2595
22/05/2018,#####,9,1633,1088,2721
22/05/2018,#####,10,1647,1110,2757
22/05/2018,#####,11,1582,1144,2726
22/05/2018,#####,12,1483,1184,2667
22/05/2018,#####,13,1419,1144,2563
22/05/2018,#####,14,1423,1070,2493
22/05/2018,#####,15,1374,1064,2438
22/05/2018,#####,16,1287,981,2268
22/05/2018,#####,17,1550,934,2484
22/05/2018,#####,18,1577,798,2375
22/05/2018,#####,19,1586,954,2540
22/05/2018,#####,20,1489,802,2291
22/05/2018,#####,21,1345,719,2064
22/05/2018,#####,22,1037,534,1571
22/05/2018,#####,23,940,549,1489
23/05/2018,#####,0,720,453,1173
23/05/2018,#####,1,736,435,1171
23/05/2018,#####,2,602,425,1027
23/05/2018,#####,3,515,407,922
23/05/2018,#####,4,515,397,912
23/05/2018,#####,5,545,462,1007
23/05/2018,#####,6,890,492,1382
23/05/2018,#####,7,1230,855,2085
23/05/2018,#####,8,1321,933,2254
23/05/2018,#####,9,1409,1013,2422
23/05/2018,#####,10,1327,1039,2366
23/05/2018,#####,11,1404,1066,2470
23/05/2018,#####,12,1215,1077,2292
23/05/2018,#####,13,1217,1089,2306
23/05/2018,#####,14,1247,1029,2276
23/05/2018,#####,15,1239,1021,2260
23/05/2018,#####,16,1244,984,2228
23/05/2018,#####,17,1245,909,2154
23/05/2018,#####,18,1458,793,2251
23/05/2018,#####,19,1350,796,2146
23/05/2018,#####,20,1157,706,1863
23/05/2018,#####,21,931,559,1490
23/05/2018,#####,22,847,526,1373
23/05/2018,#####,23,842,471,1313
24/05/2018,#####,0,910,463,1373
24/05/2018,#####,1,971,490,1461
24/05/2018,#####,2,901,478,1379
24/05/2018,#####,3,878,492,1370
24/05/2018,#####,4,851,518,1369
24/05/2018,#####,5,822,572,1394
24/05/2018,#####,6,945,687,1632
24/05/2018,#####,7,1301,1096,2397
24/05/2018,#####,8,1340,1224,2564
24/05/2018,#####,9,1412,1204,2616
24/05/2018,#####,10,1671,1396,3067
24/05/2018,#####,11,1736,1326,3062
24/05/2018,#####,12,1851,1508,3359
24/05/2018,#####,13,2118,1512,3630
24/05/2018,#####,14,2400,1436,3836
24/05/2018,#####,15,2426,1381,3807
24/05/2018,#####,16,2405,1339,3744
24/05/2018,#####,17,2202,1180,3382
24/05/2018,#####,18,1855,1049,2904
24/05/2018,#####,19,1483,980,2463
24/05/2018,#####,20,1302,886,2188
24/05/2018,#####,21,1214,841,2055
24/05/2018,#####,22,1148,873,2021
24/05/2018,#####,23,1338,873,2211
25/05/2018,#####,0,1405,855,2260
25/05/2018,#####,1,1523,816,2339
25/05/2018,#####,2,1494,850,2344
25/05/2018,#####,3,1467,826,2293
25/05/2018,#####,4,1437,825,2262
25/05/2018,#####,5,1367,802,2169
25/05/2018,#####,6,1312,754,2066
25/05/2018,#####,7,1263,855,2118
25/05/2018,#####,8,1420,962,2382
25/05/2018,#####,9,1416,1049,2465
25/05/2018,#####,10,1356,1251,2607
25/05/2018,#####,11,1456,1198,2654
25/05/2018,#####,12,1619,1145,2764
25/05/2018,#####,13,1675,1156,2831
25/05/2018,#####,14,1606,1121,2727
25/05/2018,#####,15,1578,1091,2669
25/05/2018,#####,16,1510,982,2492
25/05/2018,#####,17,1506,881,2387
25/05/2018,#####,18,1467,681,2148
25/05/2018,#####,19,1242,602,1844
25/05/2018,#####,20,877,567,1444
25/05/2018,#####,21,765,614,1379
25/05/2018,#####,22,749,637,1386
25/05/2018,#####,23,565,566,1131
26/05/2018,#####,0,634,441,1075
26/05/2018,#####,1,512,401,913
26/05/2018,#####,2,519,394,913
26/05/2018,#####,3,527,395,922
26/05/2018,#####,4,512,428,940
26/05/2018,#####,5,576,441,1017
26/05/2018,#####,6,695,415,1110
26/05/2018,#####,7,754,473,1227
26/05/2018,#####,8,798,514,1312
26/05/2018,#####,9,967,515,1482
26/05/2018,#####,10,985,520,1505
26/05/2018,#####,11,1315,630,1945
26/05/2018,#####,12,1320,654,1974
26/05/2018,#####,13,1384,645,2029
26/05/2018,#####,14,1421,558,1979
26/05/2018,#####,15,1325,539,1864
26/05/2018,#####,16,1269,484,1753
26/05/2018,#####,17,1298,416,1714
26/05/2018,#####,18,1265,392,1657
26/05/2018,#####,19,1043,491,1534
26/05/2018,#####,20,980,537,1517
26/05/2018,#####,21,834,554,1388
26/05/2018,#####,22,732,579,1311
26/05/2018,#####,23,543,443,986
27/05/2018,#####,0,396,394,790
27/05/2018,#####,1,376,444,820
27/05/2018,#####,2,405,490,895
27/05/2018,#####,3,393,444,837
27/05/2018,#####,4,480,438,918
27/05/2018,#####,5,456,497,953
27/05/2018,#####,6,487,518,1005
27/05/2018,#####,7,530,457,987
27/05/2018,#####,8,699,451,1150
27/05/2018,#####,9,872,500,1372
27/05/2018,#####,10,1163,529,1692
27/05/2018,#####,11,1397,586,1983
27/05/2018,#####,12,1574,635,2209
27/05/2018,#####,13,1734,642,2376
27/05/2018,#####,14,2053,707,2760
27/05/2018,#####,15,2270,744,3014
27/05/2018,#####,16,2365,798,3163
27/05/2018,#####,17,2259,811,3070
27/05/2018,#####,18,1963,798,2761
27/05/2018,#####,19,1556,744,2300
27/05/2018,#####,20,1315,755,2070
27/05/2018,#####,21,1335,709,2044
27/05/2018,#####,22,1553,683,2236
27/05/2018,#####,23,1554,694,2248
28/05/2018,#####,0,1607,779,2386
28/05/2018,#####,1,1605,784,2389
28/05/2018,#####,2,1632,773,2405
28/05/2018,#####,3,1576,796,2372
28/05/2018,#####,4,1679,759,2438
28/05/2018,#####,5,1640,609,2249
28/05/2018,#####,6,1912,563,2475
28/05/2018,#####,7,1816,581,2397
28/05/2018,#####,8,1777,734,2511
28/05/2018,#####,9,1712,832,2544
28/05/2018,#####,10,1559,942,2501
28/05/2018,#####,11,1458,904,2362
28/05/2018,#####,12,1479,931,2410
28/05/2018,#####,13,1515,848,2363
28/05/2018,#####,14,1498,764,2262
28/05/2018,#####,15,1381,788,2169
28/05/2018,#####,16,1390,820,2210
28/05/2018,#####,17,1321,915,2236
28/05/2018,#####,18,1253,960,2213
28/05/2018,#####,19,1144,872,2016
28/05/2018,#####,20,853,836,1689
28/05/2018,#####,21,868,759,1627
28/05/2018,#####,22,1016,720,1736
28/05/2018,#####,23,960,605,1565
29/05/2018,#####,0,958,544,1502
29/05/2018,#####,1,1012,491,1503
29/05/2018,#####,2,1046,496,1542
29/05/2018,#####,3,914,463,1377
29/05/2018,#####,4,830,404,1234
29/05/2018,#####,5,857,400,1257
29/05/2018,#####,6,964,418,1382
29/05/2018,#####,7,1049,548,1597
29/05/2018,#####,8,1075,659,1734
29/05/2018,#####,9,1282,616,1898
29/05/2018,#####,10,1395,664,2059
29/05/2018,#####,11,1434,759,2193
29/05/2018,#####,12,1415,879,2294
29/05/2018,#####,13,1403,986,2389
29/05/2018,#####,14,1436,1079,2515
29/05/2018,#####,15,1337,1135,2472
29/05/2018,#####,16,1263,1092,2355
29/05/2018,#####,17,1390,1125,2515
29/05/2018,#####,18,1429,1019,2448
29/05/2018,#####,19,1070,899,1969
29/05/2018,#####,20,946,789,1735
29/05/2018,#####,21,1305,748,2053
29/05/2018,#####,22,1057,757,1814
29/05/2018,#####,23,1516,786,2302
30/05/2018,#####,0,1700,690,2390
30/05/2018,#####,1,1769,645,2414
30/05/2018,#####,2,1845,644,2489
30/05/2018,#####,3,1865,617,2482
30/05/2018,#####,4,1852,622,2474
30/05/2018,#####,5,1911,672,2583
30/05/2018,#####,6,1941,759,2700
30/05/2018,#####,7,1765,782,2547
30/05/2018,#####,8,1737,875,2612
30/05/2018,#####,9,1934,928,2862
30/05/2018,#####,10,2185,986,3171
30/05/2018,#####,11,2382,1049,3431
30/05/2018,#####,12,2473,1116,3589
30/05/2018,#####,13,2572,1157,3729
30/05/2018,#####,14,2450,1056,3506
30/05/2018,#####,15,2176,973,3149
30/05/2018,#####,16,1921,991,2912
30/05/2018,#####,17,1746,1003,2749
30/05/2018,#####,18,1641,1053,2694
30/05/2018,#####,19,1337,1013,2350
30/05/2018,#####,20,1126,991,2117
30/05/2018,#####,21,1106,962,2068
30/05/2018,#####,22,1092,936,2028
30/05/2018,#####,23,1023,773,1796
31/05/2018,#####,0,1095,681,1776
31/05/2018,#####,1,1239,683,1922
31/05/2018,#####,2,1266,703,1969
31/05/2018,#####,3,1280,710,1990
31/05/2018,#####,4,1391,671,2062
31/05/2018,#####,5,1500,659,2159
31/05/2018,#####,6,1580,667,2247
31/05/2018,#####,7,1589,814,2403
31/05/2018,#####,8,1653,925,2578
31/05/2018,#####,9,1868,1019,2887
31/05/2018,#####,10,2045,1159,3204
31/05/2018,#####,11,2189,1210,3399
31/05/2018,#####,12,2156,1250,3406
31/05/2018,#####,13,2075,1205,3280
31/05/2018,#####,14,1940,1256,3196
31/05/2018,#####,15,1794,1258,3052
31/05/2018,#####,16,1706,1210,2916
31/05/2018,#####,17,1543,1207,2750
31/05/2018,#####,18,1343,1140,2483
31/05/2018,#####,19,1077,1069,2146
31/05/2018,#####,20,892,1001,1893
31/05/2018,#####,21,974,969,1943
31/05/2018,#####,22,1106,926,2032
31/05/2018,#####,23,1085,829,1914
01/06/2018,#####,0,1087,835,1922
01/06/2018,#####,1,1064,751,1815
01/06/2018,#####,2,1026,698,1724
01/06/2018,#####,3,958,701,1659
01/06/2018,#####,4,934,667,1601
01/06/2018,#####,5,866,678,1544
01/06/2018,#####,6,882,717,1599
01/06/2018,#####,7,886,738,1624
01/06/2018,#####,8,920,758,1678
01/06/2018,#####,9,951,807,1758
01/06/2018,#####,10,1014,1007,2021
01/06/2018,#####,11,1124,918,2042
01/06/2018,#####,12,1264,902,2166
01/06/2018,#####,13,1384,850,2234
01/06/2018,#####,14,1272,859,2131
01/06/2018,#####,15,1198,814,2012
01/06/2018,#####,16,932,795,1727
01/06/2018,#####,17,739,751,1490
01/06/2018,#####,18,625,751,1376
01/06/2018,#####,19,488,644,1132
01/06/2018,#####,20,380,559,939
01/06/2018,#####,21,403,501,904
01/06/2018,#####,22,446,446,892
01/06/2018,#####,23,487,457,944
02/06/2018,#####,0,523,342,865
02/06/2018,#####,1,489,318,807
02/06/2018,#####,2,468,323,791
02/06/2018,#####,3,422,326,748
02/06/2018,#####,4,366,319,685
02/06/2018,#####,5,371,323,694
02/06/2018,#####,6,378,345,723
02/06/2018,#####,7,457,357,814
02/06/2018,#####,8,484,417,901
02/06/2018,#####,9,560,614,1174
02/06/2018,#####,10,633,670,1303
02/06/2018,#####,11,701,699,1400
02/06/2018,#####,12,746,631,1377
02/06/2018,#####,13,761,619,1380
02/06/2018,#####,14,729,586,1315
02/06/2018,#####,15,754,568,1322
02/06/2018,#####,16,751,540,1291
02/06/2018,#####,17,659,506,1165
02/06/2018,#####,18,601,398,999
02/06/2018,#####,19,561,331,892
02/06/2018,#####,20,457,357,814
02/06/2018,#####,21,421,362,783
02/06/2018,#####,22,376,396,772
02/06/2018,#####,23,400,476,876
03/06/2018,#####,0,387,498,885
03/06/2018,#####,1,430,510,940
03/06/2018,#####,2,449,470,919
03/06/2018,#####,3,485,390,875
03/06/2018,#####,4,519,359,878
03/06/2018,#####,5,537,368,905
03/06/2018,#####,6,549,377,926
03/06/2018,#####,7,566,431,997
03/06/2018,#####,8,643,459,1102
03/06/2018,#####,9,711,510,1221
03/06/2018,#####,10,827,584,1411
03/06/2018,#####,11,1043,584,1627
03/06/2018,#####,12,1152,614,1766
03/06/2018,#####,13,1235,640,1875
03/06/2018,#####,14,1335,653,1988
03/06/2018,#####,15,1304,660,1964
03/06/2018,#####,16,1310,665,1975
03/06/2018,#####,17,1272,701,1973
03/06/2018,#####,18,1236,725,1961
03/06/2018,#####,19,1175,608,1783
03/06/2018,#####,20,1032,531,1563
03/06/2018,#####,21,1109,516,1625
03/06/2018,#####,22,1191,593,1784
03/06/2018,#####,23,1207,429,1636
04/06/2018,#####,0,1345,389,1734
04/06/2018,#####,1,1387,380,1767
04/06/2018,#####,2,1501,411,1912
04/06/2018,#####,3,1543,442,1985
04/06/2018,#####,4,1548,488,2036
04/06/2018,#####,5,1513,504,2017
04/06/2018,#####,6,1579,581,2160
04/06/2018,#####,7,1648,569,2217
04/06/2018,#####,8,1810,650,2460
04/06/2018,#####,9,1927,718,2645
04/06/2018,#####,10,1984,833,2817
04/06/2018,#####,11,2094,940,3034
04/06/2018,#####,12,2002,965,2967
04/06/2018,#####,13,1987,1021,3008
04/06/2018,#####,14,1976,1012,2988
04/06/2018,#####,15,1955,968,2923
04/06/2018,#####,16,1798,902,2700
04/06/2018,#####,17,1880,1041,2921
04/06/2018,#####,18,1837,1069,2906
04/06/2018,#####,19,1522,970,2492
04/06/2018,#####,20,1301,924,2225
04/06/2018,#####,21,1075,867,1942
04/06/2018,#####,22,944,823,1767
04/06/2018,#####,23,885,630,1515
05/06/2018,#####,0,775,563,1338
05/06/2018,#####,1,669,491,1160
05/06/2018,#####,2,549,439,988
05/06/2018,#####,3,490,445,935
05/06/2018,#####,4,685,417,1102
05/06/2018,#####,5,911,442,1353
05/06/2018,#####,6,1075,468,1543
05/06/2018,#####,7,1253,395,1648
05/06/2018,#####,8,1484,503,1987
05/06/2018,#####,9,1637,610,2247
05/06/2018,#####,10,1519,651,2170
05/06/2018,#####,11,1512,667,2179
05/06/2018,#####,12,1410,671,2081
05/06/2018,#####,13,1439,664,2103
05/06/2018,#####,14,1344,719,2063
05/06/2018,#####,15,1000,628,1628
05/06/2018,#####,16,853,628,1481
05/06/2018,#####,17,972,571,1543
05/06/2018,#####,18,780,501,1281
05/06/2018,#####,19,715,601,1316
05/06/2018,#####,20,608,569,1177
05/06/2018,#####,21,513,545,1058
05/06/2018,#####,22,599,514,1113
05/06/2018,#####,23,561,440,1001
06/06/2018,#####,0,667,393,1060
06/06/2018,#####,1,701,429,1130
06/06/2018,#####,2,757,446,1203
06/06/2018,#####,3,753,445,1198
06/06/2018,#####,4,726,441,1167
06/06/2018,#####,5,723,463,1186
06/06/2018,#####,6,794,528,1322
06/06/2018,#####,7,825,628,1453
06/06/2018,#####,8,840,757,1597
06/06/2018,#####,9,951,705,1656
06/06/2018,#####,10,1034,735,1769
06/06/2018,#####,11,1064,754,1818
06/06/2018,#####,12,1021,695,1716
06/06/2018,#####,13,1074,801,1875
06/06/2018,#####,14,1071,785,1856
06/06/2018,#####,15,889,687,1576
06/06/2018,#####,16,918,703,1621
06/06/2018,#####,17,888,752,1640
06/06/2018,#####,18,764,728,1492
06/06/2018,#####,19,638,733,1371
06/06/2018,#####,20,556,763,1319
06/06/2018,#####,21,558,743,1301
06/06/2018,#####,22,576,721,1297
06/06/2018,#####,23,672,656,1328
07/06/2018,#####,0,760,573,1333
07/06/2018,#####,1,811,515,1326
07/06/2018,#####,2,787,520,1307
07/06/2018,#####,3,751,499,1250
07/06/2018,#####,4,778,497,1275
07/06/2018,#####,5,815,494,1309
07/06/2018,#####,6,866,530,1396
07/06/2018,#####,7,1027,598,1625
07/06/2018,#####,8,1092,672,1764
07/06/2018,#####,9,1131,740,1871
07/06/2018,#####,10,1233,792,2025
07/06/2018,#####,11,1395,748,2143
07/06/2018,#####,12,1341,698,2039
07/06/2018,#####,13,1370,696,2066
07/06/2018,#####,14,1280,689,1969
07/06/2018,#####,15,1102,715,1817
07/06/2018,#####,16,998,673,1671
07/06/2018,#####,17,1054,661,1715
07/06/2018,#####,18,984,600,1584
07/06/2018,#####,19,817,545,1362
07/06/2018,#####,20,710,437,1147
07/06/2018,#####,21,597,414,1011
07/06/2018,#####,22,421,457,878
07/06/2018,#####,23,400,418,818
08/06/2018,#####,0,394,395,789
08/06/2018,#####,1,461,352,813
08/06/2018,#####,2,433,328,761
08/06/2018,#####,3,391,307,698
08/06/2018,#####,4,389,302,691
08/06/2018,#####,5,370,313,683
08/06/2018,#####,6,482,397,879
08/06/2018,#####,7,675,521,1196
08/06/2018,#####,8,775,614,1389
08/06/2018,#####,9,828,631,1459
08/06/2018,#####,10,884,690,1574
08/06/2018,#####,11,956,658,1614
08/06/2018,#####,12,941,617,1558
08/06/2018,#####,13,1013,657,1670
08/06/2018,#####,14,994,703,1697
08/06/2018,#####,15,1010,736,1746
08/06/2018,#####,16,906,725,1631
08/06/2018,#####,17,845,722,1567
08/06/2018,#####,18,804,686,1490
08/06/2018,#####,19,651,575,1226
08/06/2018,#####,20,673,450,1123
08/06/2018,#####,21,581,389,970
08/06/2018,#####,22,413,377,790
08/06/2018,#####,23,387,383,770
09/06/2018,#####,0,281,367,648
09/06/2018,#####,1,328,350,678
09/06/2018,#####,2,302,324,626
09/06/2018,#####,3,309,294,603
09/06/2018,#####,4,323,287,610
09/06/2018,#####,5,332,296,628
09/06/2018,#####,6,374,361,735
09/06/2018,#####,7,402,384,786
09/06/2018,#####,8,450,481,931
09/06/2018,#####,9,506,483,989
09/06/2018,#####,10,574,492,1066
09/06/2018,#####,11,636,520,1156
09/06/2018,#####,12,615,529,1144
09/06/2018,#####,13,629,506,1135
09/06/2018,#####,14,629,507,1136
09/06/2018,#####,15,659,439,1098
09/06/2018,#####,16,664,439,1103
09/06/2018,#####,17,623,405,1028
09/06/2018,#####,18,639,356,995
09/06/2018,#####,19,533,330,863
09/06/2018,#####,20,430,298,728
09/06/2018,#####,21,317,274,591
09/06/2018,#####,22,328,261,589
09/06/2018,#####,23,333,256,589
10/06/2018,#####,0,350,217,567
10/06/2018,#####,1,371,181,552
10/06/2018,#####,2,378,175,553
10/06/2018,#####,3,371,185,556
10/06/2018,#####,4,384,188,572
10/06/2018,#####,5,369,187,556
10/06/2018,#####,6,374,218,592
10/06/2018,#####,7,366,270,636
10/06/2018,#####,8,356,302,658
10/06/2018,#####,9,347,297,644
10/06/2018,#####,10,423,346,769
10/06/2018,#####,11,522,368,890
10/06/2018,#####,12,564,357,921
10/06/2018,#####,13,682,411,1093
10/06/2018,#####,14,664,500,1164
10/06/2018,#####,15,560,541,1101
10/06/2018,#####,16,547,441,988
10/06/2018,#####,17,698,299,997
10/06/2018,#####,18,834,281,1115
10/06/2018,#####,19,869,303,1172
10/06/2018,#####,20,884,317,1201
10/06/2018,#####,21,907,306,1213
10/06/2018,#####,22,947,375,1322
10/06/2018,#####,23,979,405,1384
11/06/2018,#####,0,1246,405,1651
11/06/2018,#####,1,1536,377,1913
11/06/2018,#####,2,1730,457,2187
11/06/2018,#####,3,1807,451,2258
11/06/2018,#####,4,1992,437,2429
11/06/2018,#####,5,2186,430,2616
11/06/2018,#####,6,2317,482,2799
11/06/2018,#####,7,2364,644,3008
11/06/2018,#####,8,2497,781,3278
11/06/2018,#####,9,2639,765,3404
11/06/2018,#####,10,2848,708,3556
11/06/2018,#####,11,3246,780,4026
11/06/2018,#####,12,3462,890,4352
11/06/2018,#####,13,3730,947,4677
11/06/2018,#####,14,3832,1023,4855
11/06/2018,#####,15,3627,1026,4653
11/06/2018,#####,16,3574,1061,4635
11/06/2018,#####,17,3769,1119,4888
11/06/2018,#####,18,3625,1066,4691
11/06/2018,#####,19,3121,982,4103
11/06/2018,#####,20,2827,928,3755
11/06/2018,#####,21,2601,897,3498
11/06/2018,#####,22,2180,866,3046
11/06/2018,#####,23,2175,776,2951
12/06/2018,#####,0,2522,769,3291
12/06/2018,#####,1,2532,746,3278
12/06/2018,#####,2,2354,673,3027
12/06/2018,#####,3,2103,617,2720
12/06/2018,#####,4,1928,590,2518
12/06/2018,#####,5,1783,511,2294
12/06/2018,#####,6,1674,478,2152
12/06/2018,#####,7,1743,475,2218
12/06/2018,#####,8,1596,537,2133
12/06/2018,#####,9,1558,544,2102
12/06/2018,#####,10,1427,555,1982
12/06/2018,#####,11,1346,607,1953
12/06/2018,#####,12,1235,624,1859
12/06/2018,#####,13,1274,626,1900
12/06/2018,#####,14,1230,632,1862
12/06/2018,#####,15,1265,651,1916
12/06/2018,#####,16,1172,639,1811
12/06/2018,#####,17,1232,581,1813
12/06/2018,#####,18,1299,548,1847
12/06/2018,#####,19,1242,468,1710
12/06/2018,#####,20,1183,478,1661
12/06/2018,#####,21,1252,468,1720
12/06/2018,#####,22,1301,445,1746
12/06/2018,#####,23,1306,379,1685
13/06/2018,#####,0,1456,362,1818
13/06/2018,#####,1,1531,310,1841
13/06/2018,#####,2,1574,352,1926
13/06/2018,#####,3,1588,342,1930
13/06/2018,#####,4,1614,364,1978
13/06/2018,#####,5,1802,394,2196
13/06/2018,#####,6,2060,372,2432
13/06/2018,#####,7,2569,398,2967
13/06/2018,#####,8,2778,396,3174
13/06/2018,#####,9,3023,419,3442
13/06/2018,#####,10,3137,514,3651
13/06/2018,#####,11,3239,611,3850
13/06/2018,#####,12,3223,732,3955
13/06/2018,#####,13,3231,824,4055
13/06/2018,#####,14,3487,928,4415
13/06/2018,#####,15,3534,985,4519
13/06/2018,#####,16,3280,969,4249
13/06/2018,#####,17,3055,899,3954
13/06/2018,#####,18,3073,850,3923
13/06/2018,#####,19,2838,773,3611
13/06/2018,#####,20,2386,656,3042
13/06/2018,#####,21,1955,524,2479
13/06/2018,#####,22,1523,472,1995
13/06/2018,#####,23,1233,355,1588
14/06/2018,#####,0,1239,323,1562
14/06/2018,#####,1,1225,354,1579
14/06/2018,#####,2,1247,386,1633
14/06/2018,#####,3,1250,381,1631
14/06/2018,#####,4,1298,263,1561
14/06/2018,#####,5,1362,221,1583
14/06/2018,#####,6,1657,269,1926
14/06/2018,#####,7,2122,397,2519
14/06/2018,#####,8,2622,471,3093
14/06/2018,#####,9,2983,536,3519
14/06/2018,#####,10,3450,660,4110
14/06/2018,#####,11,3793,761,4554
14/06/2018,#####,12,3806,772,4578
14/06/2018,#####,13,4244,837,5081
14/06/2018,#####,14,4332,842,5174
14/06/2018,#####,15,4323,820,5143
14/06/2018,#####,16,4073,763,4836
14/06/2018,#####,17,3753,742,4495
14/06/2018,#####,18,3627,710,4337
14/06/2018,#####,19,3578,752,4330
14/06/2018,#####,20,3196,678,3874
14/06/2018,#####,21,2650,478,3128
14/06/2018,#####,22,2089,479,2568
14/06/2018,#####,23,1713,522,2235
15/06/2018,#####,0,1395,532,1927
15/06/2018,#####,1,1345,463,1808
15/06/2018,#####,2,1262,381,1643
15/06/2018,#####,3,1148,305,1453
15/06/2018,#####,4,1012,255,1267
15/06/2018,#####,5,978,261,1239
15/06/2018,#####,6,1052,349,1401
15/06/2018,#####,7,1248,486,1734
15/06/2018,#####,8,1486,556,2042
15/06/2018,#####,9,1568,602,2170
15/06/2018,#####,10,1642,621,2263
15/06/2018,#####,11,1765,621,2386
15/06/2018,#####,12,1629,599,2228
15/06/2018,#####,13,1545,546,2091
15/06/2018,#####,14,1546,538,2084
15/06/2018,#####,15,1456,498,1954
15/06/2018,#####,16,1355,400,1755
15/06/2018,#####,17,1129,370,1499
15/06/2018,#####,18,889,341,1230
15/06/2018,#####,19,675,299,974
15/06/2018,#####,20,538,243,781
15/06/2018,#####,21,480,222,702
15/06/2018,#####,22,441,238,679
15/06/2018,#####,23,396,232,628
16/06/2018,#####,0,399,167,566
16/06/2018,#####,1,447,167,614
16/06/2018,#####,2,466,170,636
16/06/2018,#####,3,470,169,639
16/06/2018,#####,4,484,174,658
16/06/2018,#####,5,485,177,662
16/06/2018,#####,6,446,195,641
16/06/2018,#####,7,569,223,792
16/06/2018,#####,8,673,310,983
16/06/2018,#####,9,738,412,1150
16/06/2018,#####,10,860,512,1372
16/06/2018,#####,11,986,576,1562
16/06/2018,#####,12,1005,549,1554
16/06/2018,#####,13,1024,622,1646
16/06/2018,#####,14,1050,678,1728
16/06/2018,#####,15,1024,637,1661
16/06/2018,#####,16,1106,523,1629
16/06/2018,#####,17,1148,436,1584
16/06/2018,#####,18,1078,463,1541
16/06/2018,#####,19,1062,446,1508
16/06/2018,#####,20,1177,426,1603
16/06/2018,#####,21,1184,369,1553
16/06/2018,#####,22,1208,305,1513
16/06/2018,#####,23,1176,277,1453
17/06/2018,#####,0,1169,247,1416
17/06/2018,#####,1,1103,215,1318
17/06/2018,#####,2,1061,204,1265
17/06/2018,#####,3,1017,243,1260
17/06/2018,#####,4,958,256,1214
17/06/2018,#####,5,1008,209,1217
17/06/2018,#####,6,1048,200,1248
17/06/2018,#####,7,1228,261,1489
17/06/2018,#####,8,1566,343,1909
17/06/2018,#####,9,1863,487,2350
17/06/2018,#####,10,2155,637,2792
17/06/2018,#####,11,2455,820,3275
17/06/2018,#####,12,2725,809,3534
17/06/2018,#####,13,3077,879,3956
17/06/2018,#####,14,2610,840,3450
17/06/2018,#####,15,2923,753,3676
17/06/2018,#####,16,3157,788,3945
17/06/2018,#####,17,2841,722,3563
17/06/2018,#####,18,2927,582,3509
17/06/2018,#####,19,2761,539,3300
17/06/2018,#####,20,2420,481,2901
17/06/2018,#####,21,1959,433,2392
17/06/2018,#####,22,1626,415,2041
17/06/2018,#####,23,1394,374,1768
18/06/2018,#####,0,1334,310,1644
18/06/2018,#####,1,1262,280,1542
18/06/2018,#####,2,1223,296,1519
18/06/2018,#####,3,1170,298,1468
18/06/2018,#####,4,1144,306,1450
18/06/2018,#####,5,1086,334,1420
18/06/2018,#####,6,1218,367,1585
18/06/2018,#####,7,1556,523,2079
18/06/2018,#####,8,1757,547,2304
18/06/2018,#####,9,1890,566,2456
18/06/2018,#####,10,2460,657,3117
18/06/2018,#####,11,2738,671,3409
18/06/2018,#####,12,2862,704,3566
18/06/2018,#####,13,2777,679,3456
18/06/2018,#####,14,2713,758,3471
18/06/2018,#####,15,2537,724,3261
18/06/2018,#####,16,2354,756,3110
18/06/2018,#####,17,2270,627,2897
18/06/2018,#####,18,2178,675,2853
18/06/2018,#####,19,2037,574,2611
18/06/2018,#####,20,1777,513,2290
18/06/2018,#####,21,1632,440,2072
18/06/2018,#####,22,1628,444,2072
18/06/2018,#####,23,1701,404,2105
19/06/2018,#####,0,1950,458,2408
19/06/2018,#####,1,2022,481,2503
19/06/2018,#####,2,1962,543,2505
19/06/2018,#####,3,1938,695,2633
19/06/2018,#####,4,2016,583,2599
19/06/2018,#####,5,1991,539,2530
19/06/2018,#####,6,2206,568,2774
19/06/2018,#####,7,2223,640,2863
19/06/2018,#####,8,2547,727,3274
19/06/2018,#####,9,2879,780,3659
19/06/2018,#####,10,3221,879,4100
19/06/2018,#####,11,3270,1035,4305
19/06/2018,#####,12,3371,1031,4402
19/06/2018,#####,13,3200,908,4108
19/06/2018,#####,14,3258,922,4180
19/06/2018,#####,15,3163,893,4056
19/06/2018,#####,16,3083,835,3918
19/06/2018,#####,17,3050,824,3874
19/06/2018,#####,18,3166,951,4117
19/06/2018,#####,19,2723,817,3540
19/06/2018,#####,20,2223,623,2846
19/06/2018,#####,21,1945,521,2466
19/06/2018,#####,22,1724,560,2284
19/06/2018,#####,23,1431,540,1971
20/06/2018,#####,0,1239,487,1726
20/06/2018,#####,1,1164,454,1618
20/06/2018,#####,2,1071,407,1478
20/06/2018,#####,3,843,335,1178
20/06/2018,#####,4,702,250,952
20/06/2018,#####,5,677,220,897
20/06/2018,#####,6,897,400,1297
20/06/2018,#####,7,1239,468,1707
20/06/2018,#####,8,1502,565,2067
20/06/2018,#####,9,1843,669,2512
20/06/2018,#####,10,2622,884,3506
20/06/2018,#####,11,3107,1077,4184
20/06/2018,#####,12,3556,1151,4707
20/06/2018,#####,13,3915,1202,5117
20/06/2018,#####,14,4001,1126,5127
20/06/2018,#####,15,3880,1067,4947
20/06/2018,#####,16,3684,1005,4689
20/06/2018,#####,17,3370,905,4275
20/06/2018,#####,18,2950,769,3719
20/06/2018,#####,19,2677,661,3338
20/06/2018,#####,20,3080,681,3761
20/06/2018,#####,21,3237,752,3989
20/06/2018,#####,22,2988,705,3693
20/06/2018,#####,23,2929,602,3531
21/06/2018,#####,0,2492,552,3044
21/06/2018,#####,1,2360,590,2950
21/06/2018,#####,2,2277,614,2891
21/06/2018,#####,3,2129,584,2713
21/06/2018,#####,4,1939,568,2507
21/06/2018,#####,5,1809,591,2400
21/06/2018,#####,6,1932,650,2582
21/06/2018,#####,7,1994,640,2634
21/06/2018,#####,8,2324,620,2944
21/06/2018,#####,9,2760,647,3407
21/06/2018,#####,10,3058,609,3667
21/06/2018,#####,11,3303,694,3997
21/06/2018,#####,12,3472,629,4101
21/06/2018,#####,13,3600,656,4256
21/06/2018,#####,14,4014,837,4851
21/06/2018,#####,15,3686,848,4534
21/06/2018,#####,16,3618,1070,4688
21/06/2018,#####,17,3655,1162,4817
21/06/2018,#####,18,3588,1180,4768
21/06/2018,#####,19,3545,1173,4718
21/06/2018,#####,20,3488,1101,4589
21/06/2018,#####,21,3215,1079,4294
21/06/2018,#####,22,2951,1049,4000
21/06/2018,#####,23,2790,1025,3815
22/06/2018,#####,0,2251,976,3227
22/06/2018,#####,1,2231,941,3172
22/06/2018,#####,2,2124,894,3018
22/06/2018,#####,3,1722,804,2526
22/06/2018,#####,4,1302,632,1934
22/06/2018,#####,5,1900,642,2542
22/06/2018,#####,6,1850,637,2487
22/06/2018,#####,7,1982,647,2629
22/06/2018,#####,8,2318,678,2996
22/06/2018,#####,9,2619,662,3281
22/06/2018,#####,10,2836,687,3523
22/06/2018,#####,11,3032,753,3785
22/06/2018,#####,12,3144,853,3997
22/06/2018,#####,13,3221,1034,4255
22/06/2018,#####,14,3464,1099,4563
22/06/2018,#####,15,3692,1177,4869
22/06/2018,#####,16,3838,1184,5022
22/06/2018,#####,17,3804,1166,4970
22/06/2018,#####,18,3684,1114,4798
22/06/2018,#####,19,3741,1083,4824
22/06/2018,#####,20,3712,1060,4772
22/06/2018,#####,21,3674,995,4669
22/06/2018,#####,22,3603,962,4565
22/06/2018,#####,23,3507,975,4482
23/06/2018,#####,0,3375,937,4312
23/06/2018,#####,1,3354,937,4291
23/06/2018,#####,2,3331,927,4258
23/06/2018,#####,3,3234,912,4146
23/06/2018,#####,4,3161,896,4057
23/06/2018,#####,5,3069,895,3964
23/06/2018,#####,6,2937,905,3842
23/06/2018,#####,7,2982,969,3951
23/06/2018,#####,8,3100,1050,4150
23/06/2018,#####,9,3223,1004,4227
23/06/2018,#####,10,3172,989,4161
23/06/2018,#####,11,3055,1047,4102
23/06/2018,#####,12,2947,1020,3967
23/06/2018,#####,13,2828,964,3792
23/06/2018,#####,14,2841,919,3760
23/06/2018,#####,15,2924,941,3865
23/06/2018,#####,16,2832,903,3735
23/06/2018,#####,17,2797,883,3680
23/06/2018,#####,18,2757,845,3602
23/06/2018,#####,19,2684,800,3484
23/06/2018,#####,20,2576,778,3354
23/06/2018,#####,21,2529,762,3291
23/06/2018,#####,22,2511,732,3243
23/06/2018,#####,23,2390,712,3102
24/06/2018,#####,0,2345,641,2986
24/06/2018,#####,1,2331,527,2858
24/06/2018,#####,2,2211,475,2686
24/06/2018,#####,3,2012,452,2464
24/06/2018,#####,4,1878,415,2293
24/06/2018,#####,5,1676,377,2053
24/06/2018,#####,6,1483,400,1883
24/06/2018,#####,7,1417,431,1848
24/06/2018,#####,8,1380,427,1807
24/06/2018,#####,9,1356,422,1778
24/06/2018,#####,10,1391,441,1832
24/06/2018,#####,11,1372,473,1845
24/06/2018,#####,12,1374,439,1813
24/06/2018,#####,13,1424,432,1856
24/06/2018,#####,14,1485,434,1919
24/06/2018,#####,15,1503,476,1979
24/06/2018,#####,16,1441,481,1922
24/06/2018,#####,17,1358,452,1810
24/06/2018,#####,18,1286,407,1693
24/06/2018,#####,19,1242,403,1645
24/06/2018,#####,20,1151,366,1517
24/06/2018,#####,21,1131,368,1499
24/06/2018,#####,22,1123,402,1525
24/06/2018,#####,23,1113,439,1552
25/06/2018,#####,0,1142,402,1544
25/06/2018,#####,1,1202,387,1589
25/06/2018,#####,2,1191,348,1539
25/06/2018,#####,3,1187,306,1493
25/06/2018,#####,4,1202,307,1509
25/06/2018,#####,5,1148,301,1449
25/06/2018,#####,6,1155,334,1489
25/06/2018,#####,7,1236,416,1652
25/06/2018,#####,8,1356,491,1847
25/06/2018,#####,9,1495,485,1980
25/06/2018,#####,10,1549,541,2090
25/06/2018,#####,11,1669,637,2306
25/06/2018,#####,12,1650,694,2344
25/06/2018,#####,13,1683,679,2362
25/06/2018,#####,14,1663,649,2312
25/06/2018,#####,15,1739,596,2335
25/06/2018,#####,16,1617,572,2189
25/06/2018,#####,17,1468,604,2072
25/06/2018,#####,18,1420,597,2017
25/06/2018,#####,19,1443,551,1994
25/06/2018,#####,20,1244,466,1710
25/06/2018,#####,21,1064,445,1509
25/06/2018,#####,22,795,435,1230
25/06/2018,#####,23,864,423,1287
26/06/2018,#####,0,797,386,1183
26/06/2018,#####,1,678,330,1008
26/06/2018,#####,2,597,320,917
26/06/2018,#####,3,509,288,797
26/06/2018,#####,4,563,267,830
26/06/2018,#####,5,525,261,786
26/06/2018,#####,6,519,310,829
26/06/2018,#####,7,586,427,1013
26/06/2018,#####,8,727,497,1224
26/06/2018,#####,9,820,536,1356
26/06/2018,#####,10,936,568,1504
26/06/2018,#####,11,981,579,1560
26/06/2018,#####,12,958,605,1563
26/06/2018,#####,13,931,601,1532
26/06/2018,#####,14,830,580,1410
26/06/2018,#####,15,785,553,1338
26/06/2018,#####,16,837,456,1293
26/06/2018,#####,17,746,335,1081
26/06/2018,#####,18,663,302,965
26/06/2018,#####,19,487,290,777
26/06/2018,#####,20,359,243,602
26/06/2018,#####,21,251,168,419
26/06/2018,#####,22,247,219,466
26/06/2018,#####,23,244,203,447
27/06/2018,#####,0,251,191,442
27/06/2018,#####,1,235,197,432
27/06/2018,#####,2,260,204,464
27/06/2018,#####,3,292,185,477
27/06/2018,#####,4,363,209,572
27/06/2018,#####,5,449,242,691
27/06/2018,#####,6,713,281,994
27/06/2018,#####,7,1125,362,1487
27/06/2018,#####,8,1206,441,1647
27/06/2018,#####,9,1358,463,1821
27/06/2018,#####,10,1424,503,1927
27/06/2018,#####,11,1461,547,2008
27/06/2018,#####,12,1498,574,2072
27/06/2018,#####,13,1507,573,2080
27/06/2018,#####,14,1482,585,2067
27/06/2018,#####,15,1441,608,2049
27/06/2018,#####,16,1528,605,2133
27/06/2018,#####,17,1414,541,1955
27/06/2018,#####,18,1316,472,1788
27/06/2018,#####,19,1143,398,1541
27/06/2018,#####,20,1017,318,1335
27/06/2018,#####,21,946,276,1222
27/06/2018,#####,22,783,262,1045
27/06/2018,#####,23,536,213,749
28/06/2018,#####,0,483,204,687
28/06/2018,#####,1,423,195,618
28/06/2018,#####,2,410,194,604
28/06/2018,#####,3,433,184,617
28/06/2018,#####,4,431,173,604
28/06/2018,#####,5,491,191,682
28/06/2018,#####,6,717,277,994
28/06/2018,#####,7,871,338,1209
28/06/2018,#####,8,933,397,1330
28/06/2018,#####,9,1069,448,1517
28/06/2018,#####,10,1202,488,1690
28/06/2018,#####,11,1305,529,1834
28/06/2018,#####,12,1415,594,2009
28/06/2018,#####,13,1502,629,2131
28/06/2018,#####,14,1552,624,2176
28/06/2018,#####,15,1439,589,2028
28/06/2018,#####,16,1425,501,1926
28/06/2018,#####,17,1503,460,1963
28/06/2018,#####,18,1530,417,1947
28/06/2018,#####,19,1433,355,1788
28/06/2018,#####,20,1346,300,1646
28/06/2018,#####,21,1353,314,1667
28/06/2018,#####,22,1457,331,1788
28/06/2018,#####,23,1417,319,1736
29/06/2018,#####,0,1345,397,1742
29/06/2018,#####,1,1401,432,1833
29/06/2018,#####,2,1396,405,1801
29/06/2018,#####,3,1472,403,1875
29/06/2018,#####,4,1516,403,1919
29/06/2018,#####,5,1592,367,1959
29/06/2018,#####,6,1609,414,2023
29/06/2018,#####,7,1671,452,2123
29/06/2018,#####,8,1629,531,2160
29/06/2018,#####,9,1590,534,2124
29/06/2018,#####,10,1568,607,2175
29/06/2018,#####,11,1808,698,2506
29/06/2018,#####,12,1859,764,2623
29/06/2018,#####,13,1942,897,2839
29/06/2018,#####,14,2021,850,2871
29/06/2018,#####,15,2121,780,2901
29/06/2018,#####,16,2157,710,2867
29/06/2018,#####,17,1850,549,2399
29/06/2018,#####,18,1631,464,2095
29/06/2018,#####,19,1491,392,1883
29/06/2018,#####,20,1294,370,1664
29/06/2018,#####,21,1207,366,1573
29/06/2018,#####,22,1208,284,1492
29/06/2018,#####,23,1101,232,1333
30/06/2018,#####,0,963,241,1204
30/06/2018,#####,1,895,242,1137
30/06/2018,#####,2,823,242,1065
30/06/2018,#####,3,766,244,1010
30/06/2018,#####,4,616,239,855
30/06/2018,#####,5,634,232,866
30/06/2018,#####,6,674,239,913
30/06/2018,#####,7,610,251,861
30/06/2018,#####,8,558,282,840
30/06/2018,#####,9,668,338,1006
30/06/2018,#####,10,852,367,1219
30/06/2018,#####,11,1004,420,1424
30/06/2018,#####,12,1110,454,1564
30/06/2018,#####,13,1245,484,1729
30/06/2018,#####,14,1251,486,1737
30/06/2018,#####,15,1316,485,1801
30/06/2018,#####,16,1332,487,1819
30/06/2018,#####,17,1298,482,1780
30/06/2018,#####,18,1309,441,1750
30/06/2018,#####,19,1244,385,1629
30/06/2018,#####,20,1133,318,1451
30/06/2018,#####,21,923,283,1206
30/06/2018,#####,22,859,291,1150
30/06/2018,#####,23,854,372,1226
01/07/2018,#####,0,967,478,1445
01/07/2018,#####,1,880,481,1361
01/07/2018,#####,2,813,447,1260
01/07/2018,#####,3,821,382,1203
01/07/2018,#####,4,792,315,1107
01/07/2018,#####,5,759,287,1046
01/07/2018,#####,6,753,288,1041
01/07/2018,#####,7,685,322,1007
01/07/2018,#####,8,731,369,1100
01/07/2018,#####,9,952,403,1355
01/07/2018,#####,10,1032,430,1462
01/07/2018,#####,11,1049,437,1486
01/07/2018,#####,12,993,474,1467
01/07/2018,#####,13,951,491,1442
01/07/2018,#####,14,997,517,1514
01/07/2018,#####,15,999,518,1517
01/07/2018,#####,16,1001,497,1498
01/07/2018,#####,17,953,478,1431
01/07/2018,#####,18,883,451,1334
01/07/2018,#####,19,833,353,1186
01/07/2018,#####,20,761,286,1047
01/07/2018,#####,21,643,252,895
01/07/2018,#####,22,621,229,850
01/07/2018,#####,23,609,224,833
02/07/2018,#####,0,546,249,795
02/07/2018,#####,1,457,242,699
02/07/2018,#####,2,367,221,588
02/07/2018,#####,3,392,242,634
02/07/2018,#####,4,448,271,719
02/07/2018,#####,5,439,312,751
02/07/2018,#####,6,445,345,790
02/07/2018,#####,7,790,441,1231
02/07/2018,#####,8,804,540,1344
02/07/2018,#####,9,1059,667,1726
02/07/2018,#####,10,1201,669,1870
02/07/2018,#####,11,1273,591,1864
02/07/2018,#####,12,1366,604,1970
02/07/2018,#####,13,1462,698,2160
02/07/2018,#####,14,1564,711,2275
02/07/2018,#####,15,1739,761,2500
02/07/2018,#####,16,1849,802,2651
02/07/2018,#####,17,1865,801,2666
02/07/2018,#####,18,1859,710,2569
02/07/2018,#####,19,1741,538,2279
02/07/2018,#####,20,1568,400,1968
02/07/2018,#####,21,1435,389,1824
02/07/2018,#####,22,1328,356,1684
02/07/2018,#####,23,1224,335,1559
03/07/2018,#####,0,1179,309,1488
03/07/2018,#####,1,1233,286,1519
03/07/2018,#####,2,1210,240,1450
03/07/2018,#####,3,1175,207,1382
03/07/2018,#####,4,959,189,1148
03/07/2018,#####,5,985,221,1206
03/07/2018,#####,6,1242,239,1481
03/07/2018,#####,7,1216,281,1497
03/07/2018,#####,8,1140,322,1462
03/07/2018,#####,9,1522,430,1952
03/07/2018,#####,10,1597,524,2121
03/07/2018,#####,11,1647,626,2273
03/07/2018,#####,12,1688,649,2337
03/07/2018,#####,13,1715,651,2366
03/07/2018,#####,14,1681,633,2314
03/07/2018,#####,15,1649,596,2245
03/07/2018,#####,16,1618,561,2179
03/07/2018,#####,17,1505,562,2067
03/07/2018,#####,18,1392,493,1885
03/07/2018,#####,19,1222,418,1640
03/07/2018,#####,20,1061,375,1436
03/07/2018,#####,21,989,416,1405
03/07/2018,#####,22,1032,433,1465
03/07/2018,#####,23,947,416,1363
04/07/2018,#####,0,809,322,1131
04/07/2018,#####,1,843,345,1188
04/07/2018,#####,2,853,321,1174
04/07/2018,#####,3,716,302,1018
04/07/2018,#####,4,719,291,1010
04/07/2018,#####,5,648,283,931
04/07/2018,#####,6,794,297,1091
04/07/2018,#####,7,867,337,1204
04/07/2018,#####,8,893,404,1297
04/07/2018,#####,9,949,464,1413
04/07/2018,#####,10,1060,519,1579
04/07/2018,#####,11,1102,555,1657
04/07/2018,#####,12,1108,551,1659
04/07/2018,#####,13,1188,557,1745
04/07/2018,#####,14,1228,549,1777
04/07/2018,#####,15,1298,543,1841
04/07/2018,#####,16,1260,510,1770
04/07/2018,#####,17,1308,465,1773
04/07/2018,#####,18,1314,435,1749
04/07/2018,#####,19,1242,400,1642
04/07/2018,#####,20,1205,367,1572
04/07/2018,#####,21,1128,328,1456
04/07/2018,#####,22,1242,322,1564
04/07/2018,#####,23,1152,283,1435
05/07/2018,#####,0,1089,313,1402
05/07/2018,#####,1,1002,307,1309
05/07/2018,#####,2,885,301,1186
05/07/2018,#####,3,923,325,1248
05/07/2018,#####,4,923,343,1266
05/07/2018,#####,5,885,326,1211
05/07/2018,#####,6,1199,340,1539
05/07/2018,#####,7,1282,398,1680
05/07/2018,#####,8,1316,385,1701
05/07/2018,#####,9,1417,439,1856
05/07/2018,#####,10,1455,478,1933
05/07/2018,#####,11,1359,532,1891
05/07/2018,#####,12,1470,564,2034
05/07/2018,#####,13,1701,593,2294
05/07/2018,#####,14,1937,608,2545
05/07/2018,#####,15,2041,613,2654
05/07/2018,#####,16,2015,637,2652
05/07/2018,#####,17,2094,689,2783
05/07/2018,#####,18,2137,696,2833
05/07/2018,#####,19,1999,703,2702
05/07/2018,#####,20,1973,664,2637
05/07/2018,#####,21,2015,636,2651
05/07/2018,#####,22,2040,592,2632
05/07/2018,#####,23,1853,505,2358
06/07/2018,#####,0,1883,499,2382
06/07/2018,#####,1,2069,528,2597
06/07/2018,#####,2,2272,595,2867
06/07/2018,#####,3,2420,601,3021
06/07/2018,#####,4,2467,637,3104
06/07/2018,#####,5,2428,688,3116
06/07/2018,#####,6,2483,788,3271
06/07/2018,#####,7,2663,854,3517
06/07/2018,#####,8,3139,915,4054
06/07/2018,#####,9,3094,1007,4101
06/07/2018,#####,10,3121,1089,4210
06/07/2018,#####,11,3264,1108,4372
06/07/2018,#####,12,3649,1195,4844
06/07/2018,#####,13,3619,1205,4824
06/07/2018,#####,14,3676,1213,4889
06/07/2018,#####,15,3636,1248,4884
06/07/2018,#####,16,3613,1229,4842
06/07/2018,#####,17,3518,1182,4700
06/07/2018,#####,18,3340,1115,4455
06/07/2018,#####,19,3072,1017,4089
06/07/2018,#####,20,2824,982,3806
06/07/2018,#####,21,2684,928,3612
06/07/2018,#####,22,2603,827,3430
06/07/2018,#####,23,2584,767,3351
07/07/2018,#####,0,2694,766,3460
07/07/2018,#####,1,2754,777,3531
07/07/2018,#####,2,2884,760,3644
07/07/2018,#####,3,2880,736,3616
07/07/2018,#####,4,2804,779,3583
07/07/2018,#####,5,2742,792,3534
07/07/2018,#####,6,2736,842,3578
07/07/2018,#####,7,2940,949,3889
07/07/2018,#####,8,3103,1025,4128
07/07/2018,#####,9,3093,1023,4116
07/07/2018,#####,10,3085,1014,4099
07/07/2018,#####,11,3039,1030,4069
07/07/2018,#####,12,2871,1102,3973
07/07/2018,#####,13,2782,1097,3879
07/07/2018,#####,14,2676,1077,3753
07/07/2018,#####,15,2606,1060,3666
07/07/2018,#####,16,2483,1000,3483
07/07/2018,#####,17,2363,929,3292
07/07/2018,#####,18,2156,846,3002
07/07/2018,#####,19,1950,778,2728
07/07/2018,#####,20,1755,716,2471
07/07/2018,#####,21,1603,696,2299
07/07/2018,#####,22,1496,707,2203
07/07/2018,#####,23,1529,671,2200
08/07/2018,#####,0,1509,639,2148
08/07/2018,#####,1,1410,568,1978
08/07/2018,#####,2,1284,489,1773
08/07/2018,#####,3,1144,464,1608
08/07/2018,#####,4,1121,383,1504
08/07/2018,#####,5,1025,332,1357
08/07/2018,#####,6,936,323,1259
08/07/2018,#####,7,962,359,1321
08/07/2018,#####,8,1012,363,1375
08/07/2018,#####,9,1050,419,1469
08/07/2018,#####,10,1087,438,1525
08/07/2018,#####,11,1146,469,1615
08/07/2018,#####,12,1209,517,1726
08/07/2018,#####,13,1308,508,1816
08/07/2018,#####,14,1424,523,1947
08/07/2018,#####,15,1621,605,2226
08/07/2018,#####,16,1864,598,2462
08/07/2018,#####,17,1937,521,2458
08/07/2018,#####,18,2005,476,2481
08/07/2018,#####,19,1971,521,2492
08/07/2018,#####,20,1993,622,2615
08/07/2018,#####,21,1882,661,2543
08/07/2018,#####,22,1892,646,2538
08/07/2018,#####,23,1997,653,2650
09/07/2018,#####,0,2192,542,2734
09/07/2018,#####,1,2328,533,2861
09/07/2018,#####,2,2601,539,3140
09/07/2018,#####,3,2880,519,3399
09/07/2018,#####,4,3204,526,3730
09/07/2018,#####,5,3303,607,3910
09/07/2018,#####,6,3445,741,4186
09/07/2018,#####,7,3558,729,4287
09/07/2018,#####,8,3501,888,4389
09/07/2018,#####,9,3834,988,4822
09/07/2018,#####,10,3816,1024,4840
09/07/2018,#####,11,3758,1059,4817
09/07/2018,#####,12,3630,1058,4688
09/07/2018,#####,13,3575,1106,4681
09/07/2018,#####,14,3370,1057,4427
09/07/2018,#####,15,3384,1105,4489
09/07/2018,#####,16,3394,1061,4455
09/07/2018,#####,17,3167,1032,4199
09/07/2018,#####,18,2956,982,3938
09/07/2018,#####,19,2508,847,3355
09/07/2018,#####,20,2054,924,2978
09/07/2018,#####,21,1635,833,2468
09/07/2018,#####,22,1491,685,2176
09/07/2018,#####,23,1355,475,1830
10/07/2018,#####,0,1344,354,1698
10/07/2018,#####,1,1429,356,1785
10/07/2018,#####,2,1599,373,1972
10/07/2018,#####,3,1652,350,2002
10/07/2018,#####,4,1741,291,2032
10/07/2018,#####,5,1962,294,2256
10/07/2018,#####,6,1904,329,2233
10/07/2018,#####,7,2095,427,2522
10/07/2018,#####,8,2128,560,2688
10/07/2018,#####,9,2073,768,2841
10/07/2018,#####,10,2343,722,3065
10/07/2018,#####,11,2348,680,3028
10/07/2018,#####,12,2304,728,3032
10/07/2018,#####,13,2475,789,3264
10/07/2018,#####,14,2288,751,3039
10/07/2018,#####,15,2036,697,2733
10/07/2018,#####,16,1746,595,2341
10/07/2018,#####,17,1450,544,1994
10/07/2018,#####,18,1190,480,1670
10/07/2018,#####,19,997,494,1491
10/07/2018,#####,20,811,603,1414
10/07/2018,#####,21,685,677,1362
10/07/2018,#####,22,764,649,1413
10/07/2018,#####,23,577,560,1137
11/07/2018,#####,0,617,522,1139
11/07/2018,#####,1,818,568,1386
11/07/2018,#####,2,891,577,1468
11/07/2018,#####,3,928,576,1504
11/07/2018,#####,4,919,562,1481
11/07/2018,#####,5,730,578,1308
11/07/2018,#####,6,900,673,1573
11/07/2018,#####,7,1016,761,1777
11/07/2018,#####,8,1020,802,1822
11/07/2018,#####,9,1152,833,1985
11/07/2018,#####,10,1308,877,2185
11/07/2018,#####,11,1478,892,2370
11/07/2018,#####,12,1580,962,2542
11/07/2018,#####,13,1670,898,2568
11/07/2018,#####,14,1667,865,2532
11/07/2018,#####,15,1747,775,2522
11/07/2018,#####,16,1781,687,2468
11/07/2018,#####,17,1775,619,2394
11/07/2018,#####,18,1680,553,2233
11/07/2018,#####,19,1451,513,1964
11/07/2018,#####,20,1207,466,1673
11/07/2018,#####,21,1017,555,1572
11/07/2018,#####,22,893,538,1431
11/07/2018,#####,23,752,451,1203
12/07/2018,#####,0,597,413,1010
12/07/2018,#####,1,471,384,855
12/07/2018,#####,2,476,395,871
12/07/2018,#####,3,487,416,903
12/07/2018,#####,4,461,416,877
12/07/2018,#####,5,477,405,882
12/07/2018,#####,6,618,441,1059
12/07/2018,#####,7,945,545,1490
12/07/2018,#####,8,1070,607,1677
12/07/2018,#####,9,1160,622,1782
12/07/2018,#####,10,1186,683,1869
12/07/2018,#####,11,1218,722,1940
12/07/2018,#####,12,1233,725,1958
12/07/2018,#####,13,1240,722,1962
12/07/2018,#####,14,1226,737,1963
12/07/2018,#####,15,1330,754,2084
12/07/2018,#####,16,1275,657,1932
12/07/2018,#####,17,1238,619,1857
12/07/2018,#####,18,1194,539,1733
12/07/2018,#####,19,1057,476,1533
12/07/2018,#####,20,952,446,1398
12/07/2018,#####,21,881,418,1299
12/07/2018,#####,22,993,542,1535
12/07/2018,#####,23,861,564,1425
13/07/2018,#####,0,750,586,1336
13/07/2018,#####,1,839,444,1283
13/07/2018,#####,2,1101,498,1599
13/07/2018,#####,3,1115,517,1632
13/07/2018,#####,4,1118,537,1655
13/07/2018,#####,5,1071,627,1698
13/07/2018,#####,6,1077,642,1719
13/07/2018,#####,7,1439,701,2140
13/07/2018,#####,8,1487,703,2190
13/07/2018,#####,9,1601,714,2315
13/07/2018,#####,10,1720,744,2464
13/07/2018,#####,11,1917,800,2717
13/07/2018,#####,12,2045,860,2905
13/07/2018,#####,13,2144,804,2948
13/07/2018,#####,14,2246,823,3069
13/07/2018,#####,15,2284,875,3159
13/07/2018,#####,16,2299,911,3210
13/07/2018,#####,17,2095,903,2998
13/07/2018,#####,18,2146,1030,3176
13/07/2018,#####,19,2123,1046,3169
13/07/2018,#####,20,2009,914,2923
13/07/2018,#####,21,1906,843,2749
13/07/2018,#####,22,1837,855,2692
13/07/2018,#####,23,1612,838,2450
14/07/2018,#####,0,1674,850,2524
14/07/2018,#####,1,1844,802,2646
14/07/2018,#####,2,1796,622,2418
14/07/2018,#####,3,1682,549,2231
14/07/2018,#####,4,1474,510,1984
14/07/2018,#####,5,1339,511,1850
14/07/2018,#####,6,1376,509,1885
14/07/2018,#####,7,1473,507,1980
14/07/2018,#####,8,1500,523,2023
14/07/2018,#####,9,1627,546,2173
14/07/2018,#####,10,1606,600,2206
14/07/2018,#####,11,1667,662,2329
14/07/2018,#####,12,1740,688,2428
14/07/2018,#####,13,1920,686,2606
14/07/2018,#####,14,2068,683,2751
14/07/2018,#####,15,2163,719,2882
14/07/2018,#####,16,2264,692,2956
14/07/2018,#####,17,2272,676,2948
14/07/2018,#####,18,2138,669,2807
14/07/2018,#####,19,1889,614,2503
14/07/2018,#####,20,1559,538,2097
14/07/2018,#####,21,1396,501,1897
14/07/2018,#####,22,1348,515,1863
14/07/2018,#####,23,1376,533,1909
15/07/2018,#####,0,1464,505,1969
15/07/2018,#####,1,1419,497,1916
15/07/2018,#####,2,1243,497,1740
15/07/2018,#####,3,1251,434,1685
15/07/2018,#####,4,1186,396,1582
15/07/2018,#####,5,1125,376,1501
15/07/2018,#####,6,1112,362,1474
15/07/2018,#####,7,1091,400,1491
15/07/2018,#####,8,1215,444,1659
15/07/2018,#####,9,1233,493,1726
15/07/2018,#####,10,1277,539,1816
15/07/2018,#####,11,1282,581,1863
15/07/2018,#####,12,1265,627,1892
15/07/2018,#####,13,1270,649,1919
15/07/2018,#####,14,1259,671,1930
15/07/2018,#####,15,1234,661,1895
15/07/2018,#####,16,1232,624,1856
15/07/2018,#####,17,1122,574,1696
15/07/2018,#####,18,987,521,1508
15/07/2018,#####,19,894,458,1352
15/07/2018,#####,20,832,407,1239
15/07/2018,#####,21,722,401,1123
15/07/2018,#####,22,668,396,1064
15/07/2018,#####,23,662,381,1043
16/07/2018,#####,0,522,351,873
16/07/2018,#####,1,537,346,883
16/07/2018,#####,2,450,343,793
16/07/2018,#####,3,430,341,771
16/07/2018,#####,4,441,365,806
16/07/2018,#####,5,456,389,845
16/07/2018,#####,6,711,427,1138
16/07/2018,#####,7,839,527,1366
16/07/2018,#####,8,931,594,1525
16/07/2018,#####,9,1035,673,1708
16/07/2018,#####,10,1091,715,1806
16/07/2018,#####,11,1161,733,1894
16/07/2018,#####,12,1195,744,1939
16/07/2018,#####,13,1241,694,1935
16/07/2018,#####,14,1240,682,1922
16/07/2018,#####,15,1325,682,2007
16/07/2018,#####,16,1290,627,1917
16/07/2018,#####,17,1297,591,1888
16/07/2018,#####,18,1268,527,1795
16/07/2018,#####,19,1197,520,1717
16/07/2018,#####,20,1045,494,1539
16/07/2018,#####,21,992,477,1469
16/07/2018,#####,22,935,467,1402
16/07/2018,#####,23,895,393,1288
17/07/2018,#####,0,766,372,1138
17/07/2018,#####,1,742,358,1100
17/07/2018,#####,2,711,350,1061
17/07/2018,#####,3,695,355,1050
17/07/2018,#####,4,562,348,910
17/07/2018,#####,5,511,347,858
17/07/2018,#####,6,649,398,1047
17/07/2018,#####,7,849,447,1296
17/07/2018,#####,8,887,454,1341
17/07/2018,#####,9,988,459,1447
17/07/2018,#####,10,1055,530,1585
17/07/2018,#####,11,1110,552,1662
17/07/2018,#####,12,1113,553,1666
17/07/2018,#####,13,1166,541,1707
17/07/2018,#####,14,1110,508,1618
17/07/2018,#####,15,1116,517,1633
17/07/2018,#####,16,1074,541,1615
17/07/2018,#####,17,1130,524,1654
17/07/2018,#####,18,1010,472,1482
17/07/2018,#####,19,923,442,1365
17/07/2018,#####,20,725,410,1135
17/07/2018,#####,21,667,387,1054
17/07/2018,#####,22,709,377,1086
17/07/2018,#####,23,638,348,986
18/07/2018,#####,0,692,319,1011
18/07/2018,#####,1,769,337,1106
18/07/2018,#####,2,763,346,1109
18/07/2018,#####,3,621,419,1040
18/07/2018,#####,4,623,428,1051
18/07/2018,#####,5,603,536,1139
18/07/2018,#####,6,720,635,1355
18/07/2018,#####,7,991,691,1682
18/07/2018,#####,8,1180,742,1922
18/07/2018,#####,9,1355,687,2042
18/07/2018,#####,10,1546,716,2262
18/07/2018,#####,11,1621,776,2397
18/07/2018,#####,12,1722,830,2552
18/07/2018,#####,13,1836,861,2697
18/07/2018,#####,14,1934,898,2832
18/07/2018,#####,15,1989,927,2916
18/07/2018,#####,16,1880,935,2815
18/07/2018,#####,17,1953,929,2882
18/07/2018,#####,18,2024,853,2877
18/07/2018,#####,19,1881,839,2720
18/07/2018,#####,20,1611,796,2407
18/07/2018,#####,21,1483,810,2293
18/07/2018,#####,22,1376,742,2118
18/07/2018,#####,23,1330,705,2035
19/07/2018,#####,0,1255,700,1955
19/07/2018,#####,1,1357,696,2053
19/07/2018,#####,2,1343,677,2020
19/07/2018,#####,3,1263,652,1915
19/07/2018,#####,4,1131,556,1687
19/07/2018,#####,5,1189,562,1751
19/07/2018,#####,6,1295,606,1901
19/07/2018,#####,7,1455,639,2094
19/07/2018,#####,8,1645,734,2379
19/07/2018,#####,9,1758,822,2580
19/07/2018,#####,10,1830,814,2644
19/07/2018,#####,11,1842,831,2673
19/07/2018,#####,12,1919,883,2802
19/07/2018,#####,13,1969,881,2850
19/07/2018,#####,14,1969,800,2769
19/07/2018,#####,15,2066,737,2803
19/07/2018,#####,16,2042,703,2745
19/07/2018,#####,17,1981,639,2620
19/07/2018,#####,18,1985,587,2572
19/07/2018,#####,19,1852,536,2388
19/07/2018,#####,20,1627,521,2148
19/07/2018,#####,21,1429,559,1988
19/07/2018,#####,22,1332,595,1927
19/07/2018,#####,23,1291,602,1893
20/07/2018,#####,0,1208,555,1763
20/07/2018,#####,1,1277,506,1783
20/07/2018,#####,2,1287,456,1743
20/07/2018,#####,3,1303,492,1795
20/07/2018,#####,4,1309,463,1772
20/07/2018,#####,5,1320,492,1812
20/07/2018,#####,6,1416,511,1927
20/07/2018,#####,7,1548,551,2099
20/07/2018,#####,8,1750,613,2363
20/07/2018,#####,9,1947,663,2610
20/07/2018,#####,10,1988,716,2704
20/07/2018,#####,11,2082,788,2870
20/07/2018,#####,12,2141,848,2989
20/07/2018,#####,13,2192,876,3068
20/07/2018,#####,14,2114,849,2963
20/07/2018,#####,15,1914,806,2720
20/07/2018,#####,16,1745,739,2484
20/07/2018,#####,17,1594,671,2265
20/07/2018,#####,18,1505,572,2077
20/07/2018,#####,19,1327,475,1802
20/07/2018,#####,20,1049,430,1479
20/07/2018,#####,21,944,444,1388
20/07/2018,#####,22,947,386,1333
20/07/2018,#####,23,965,370,1335
21/07/2018,#####,0,960,370,1330
21/07/2018,#####,1,826,322,1148
21/07/2018,#####,2,753,333,1086
21/07/2018,#####,3,772,339,1111
21/07/2018,#####,4,756,317,1073
21/07/2018,#####,5,740,345,1085
21/07/2018,#####,6,753,374,1127
21/07/2018,#####,7,765,422,1187
21/07/2018,#####,8,1002,487,1489
21/07/2018,#####,9,1216,544,1760
21/07/2018,#####,10,1348,588,1936
21/07/2018,#####,11,1493,624,2117
21/07/2018,#####,12,1587,649,2236
21/07/2018,#####,13,1668,651,2319
21/07/2018,#####,14,1718,654,2372
21/07/2018,#####,15,1719,633,2352
21/07/2018,#####,16,1640,599,2239
21/07/2018,#####,17,1473,552,2025
21/07/2018,#####,18,1394,487,1881
21/07/2018,#####,19,1192,429,1621
21/07/2018,#####,20,1001,384,1385
21/07/2018,#####,21,850,380,1230
21/07/2018,#####,22,845,382,1227
21/07/2018,#####,23,871,371,1242
22/07/2018,#####,0,882,369,1251
22/07/2018,#####,1,736,364,1100
22/07/2018,#####,2,751,370,1121
22/07/2018,#####,3,736,361,1097
22/07/2018,#####,4,777,348,1125
22/07/2018,#####,5,808,353,1161
22/07/2018,#####,6,827,378,1205
22/07/2018,#####,7,882,404,1286
22/07/2018,#####,8,1118,442,1560
22/07/2018,#####,9,1424,509,1933
22/07/2018,#####,10,1487,529,2016
22/07/2018,#####,11,1606,558,2164
22/07/2018,#####,12,1685,605,2290
22/07/2018,#####,13,1704,619,2323
22/07/2018,#####,14,1702,598,2300
22/07/2018,#####,15,1653,608,2261
22/07/2018,#####,16,1727,582,2309
22/07/2018,#####,17,1706,548,2254
22/07/2018,#####,18,1647,507,2154
22/07/2018,#####,19,1486,481,1967
22/07/2018,#####,20,1289,497,1786
22/07/2018,#####,21,1171,533,1704
22/07/2018,#####,22,1127,574,1701
22/07/2018,#####,23,1120,538,1658
23/07/2018,#####,0,957,489,1446
23/07/2018,#####,1,976,470,1446
23/07/2018,#####,2,1007,466,1473
23/07/2018,#####,3,989,471,1460
23/07/2018,#####,4,1004,465,1469
23/07/2018,#####,5,1025,477,1502
23/07/2018,#####,6,1301,515,1816
23/07/2018,#####,7,1488,541,2029
23/07/2018,#####,8,1642,561,2203
23/07/2018,#####,9,1692,585,2277
23/07/2018,#####,10,1787,729,2516
23/07/2018,#####,11,1777,826,2603
23/07/2018,#####,12,1812,791,2603
23/07/2018,#####,13,1771,745,2516
23/07/2018,#####,14,1784,724,2508
23/07/2018,#####,15,1792,734,2526
23/07/2018,#####,16,1862,709,2571
23/07/2018,#####,17,1898,643,2541
23/07/2018,#####,18,1725,507,2232
23/07/2018,#####,19,1464,473,1937
23/07/2018,#####,20,1253,463,1716
23/07/2018,#####,21,1100,468,1568
23/07/2018,#####,22,1023,464,1487
23/07/2018,#####,23,911,394,1305
24/07/2018,#####,0,892,375,1267
24/07/2018,#####,1,853,347,1200
24/07/2018,#####,2,776,322,1098
24/07/2018,#####,3,788,328,1116
24/07/2018,#####,4,780,325,1105
24/07/2018,#####,5,769,320,1089
24/07/2018,#####,6,763,346,1109
24/07/2018,#####,7,869,392,1261
24/07/2018,#####,8,953,476,1429
24/07/2018,#####,9,1005,510,1515
24/07/2018,#####,10,1076,556,1632
24/07/2018,#####,11,1178,571,1749
24/07/2018,#####,12,1150,587,1737
24/07/2018,#####,13,1230,596,1826
24/07/2018,#####,14,1205,607,1812
24/07/2018,#####,15,1186,620,1806
24/07/2018,#####,16,1219,635,1854
24/07/2018,#####,17,1078,601,1679
24/07/2018,#####,18,980,555,1535
24/07/2018,#####,19,875,496,1371
24/07/2018,#####,20,709,463,1172
24/07/2018,#####,21,667,475,1142
24/07/2018,#####,22,643,470,1113
24/07/2018,#####,23,598,477,1075
25/07/2018,#####,0,654,396,1050
25/07/2018,#####,1,709,336,1045
25/07/2018,#####,2,678,336,1014
25/07/2018,#####,3,698,331,1029
25/07/2018,#####,4,713,337,1050
25/07/2018,#####,5,727,341,1068
25/07/2018,#####,6,739,369,1108
25/07/2018,#####,7,816,484,1300
25/07/2018,#####,8,843,557,1400
25/07/2018,#####,9,927,610,1537
25/07/2018,#####,10,1028,661,1689
25/07/2018,#####,11,1133,694,1827
25/07/2018,#####,12,1182,719,1901
25/07/2018,#####,13,1194,728,1922
25/07/2018,#####,14,1173,706,1879
25/07/2018,#####,15,1282,679,1961
25/07/2018,#####,16,1350,617,1967
25/07/2018,#####,17,1360,600,1960
25/07/2018,#####,18,1310,549,1859
25/07/2018,#####,19,1185,513,1698
25/07/2018,#####,20,1099,508,1607
25/07/2018,#####,21,1034,491,1525
25/07/2018,#####,22,1043,473,1516
25/07/2018,#####,23,1035,402,1437
26/07/2018,#####,0,993,366,1359
26/07/2018,#####,1,1028,360,1388
26/07/2018,#####,2,1013,383,1396
26/07/2018,#####,3,987,393,1380
26/07/2018,#####,4,994,407,1401
26/07/2018,#####,5,989,417,1406
26/07/2018,#####,6,1038,447,1485
26/07/2018,#####,7,977,549,1526
26/07/2018,#####,8,1018,631,1649
26/07/2018,#####,9,1102,690,1792
26/07/2018,#####,10,1144,719,1863
26/07/2018,#####,11,1159,741,1900
26/07/2018,#####,12,1192,750,1942
26/07/2018,#####,13,1184,754,1938
26/07/2018,#####,14,1157,713,1870
26/07/2018,#####,15,1092,651,1743
26/07/2018,#####,16,1036,609,1645
26/07/2018,#####,17,965,577,1542
26/07/2018,#####,18,975,591,1566
26/07/2018,#####,19,1041,556,1597
26/07/2018,#####,20,965,516,1481
26/07/2018,#####,21,1063,470,1533
26/07/2018,#####,22,1287,406,1693
26/07/2018,#####,23,1313,410,1723
27/07/2018,#####,0,1237,461,1698
27/07/2018,#####,1,1386,438,1824
27/07/2018,#####,2,1430,423,1853
27/07/2018,#####,3,1431,414,1845
27/07/2018,#####,4,1297,389,1686
27/07/2018,#####,5,1248,432,1680
27/07/2018,#####,6,1258,468,1726
27/07/2018,#####,7,1316,551,1867
27/07/2018,#####,8,1287,718,2005
27/07/2018,#####,9,1357,819,2176
27/07/2018,#####,10,1436,949,2385
27/07/2018,#####,11,1438,989,2427
27/07/2018,#####,12,1564,1042,2606
27/07/2018,#####,13,1598,1026,2624
27/07/2018,#####,14,1738,983,2721
27/07/2018,#####,15,1853,1048,2901
27/07/2018,#####,16,1962,1095,3057
27/07/2018,#####,17,2023,1071,3094
27/07/2018,#####,18,2071,1023,3094
27/07/2018,#####,19,1728,954,2682
27/07/2018,#####,20,1813,876,2689
27/07/2018,#####,21,1746,843,2589
27/07/2018,#####,22,1822,786,2608
27/07/2018,#####,23,1887,763,2650
28/07/2018,#####,0,1854,755,2609
28/07/2018,#####,1,1804,758,2562
28/07/2018,#####,2,1785,689,2474
28/07/2018,#####,3,1802,689,2491
28/07/2018,#####,4,1861,687,2548
28/07/2018,#####,5,1966,645,2611
28/07/2018,#####,6,2002,638,2640
28/07/2018,#####,7,2160,698,2858
28/07/2018,#####,8,2580,794,3374
28/07/2018,#####,9,2947,859,3806
28/07/2018,#####,10,3171,876,4047
28/07/2018,#####,11,3137,896,4033
28/07/2018,#####,12,3284,927,4211
28/07/2018,#####,13,3278,965,4243
28/07/2018,#####,14,2993,975,3968
28/07/2018,#####,15,2880,1025,3905
28/07/2018,#####,16,2617,1022,3639
28/07/2018,#####,17,2169,942,3111
28/07/2018,#####,18,1734,767,2501
28/07/2018,#####,19,1358,689,2047
28/07/2018,#####,20,1011,461,1472
28/07/2018,#####,21,1008,361,1369
28/07/2018,#####,22,1022,279,1301
28/07/2018,#####,23,965,266,1231
29/07/2018,#####,0,928,291,1219
29/07/2018,#####,1,1008,399,1407
29/07/2018,#####,2,1011,429,1440
29/07/2018,#####,3,1045,565,1610
29/07/2018,#####,4,977,554,1531
29/07/2018,#####,5,900,525,1425
29/07/2018,#####,6,967,456,1423
29/07/2018,#####,7,960,397,1357
29/07/2018,#####,8,974,410,1384
29/07/2018,#####,9,1073,463,1536
29/07/2018,#####,10,1227,497,1724
29/07/2018,#####,11,1287,502,1789
29/07/2018,#####,12,1317,504,1821
29/07/2018,#####,13,1322,522,1844
29/07/2018,#####,14,1301,505,1806
29/07/2018,#####,15,1214,477,1691
29/07/2018,#####,16,1243,459,1702
29/07/2018,#####,17,1246,436,1682
29/07/2018,#####,18,1302,371,1673
29/07/2018,#####,19,1379,333,1712
29/07/2018,#####,20,1346,336,1682
29/07/2018,#####,21,1354,342,1696
29/07/2018,#####,22,1399,413,1812
29/07/2018,#####,23,1406,473,1879
30/07/2018,#####,0,1350,473,1823
30/07/2018,#####,1,1337,431,1768
30/07/2018,#####,2,1230,428,1658
30/07/2018,#####,3,1174,442,1616
30/07/2018,#####,4,1294,403,1697
30/07/2018,#####,5,1242,396,1638
30/07/2018,#####,6,1302,404,1706
30/07/2018,#####,7,1211,466,1677
30/07/2018,#####,8,1177,586,1763
30/07/2018,#####,9,1100,556,1656
30/07/2018,#####,10,1118,601,1719
30/07/2018,#####,11,1258,623,1881
30/07/2018,#####,12,1241,656,1897
30/07/2018,#####,13,1196,659,1855
30/07/2018,#####,14,1192,677,1869
30/07/2018,#####,15,1217,720,1937
30/07/2018,#####,16,1205,721,1926
30/07/2018,#####,17,1070,704,1774
30/07/2018,#####,18,972,604,1576
30/07/2018,#####,19,881,543,1424
30/07/2018,#####,20,752,524,1276
30/07/2018,#####,21,734,531,1265
30/07/2018,#####,22,855,600,1455
30/07/2018,#####,23,1056,580,1636
31/07/2018,#####,0,1151,548,1699
31/07/2018,#####,1,1329,508,1837
31/07/2018,#####,2,1392,449,1841
31/07/2018,#####,3,1430,458,1888
31/07/2018,#####,4,1499,471,1970
31/07/2018,#####,5,1361,490,1851
31/07/2018,#####,6,1462,531,1993
31/07/2018,#####,7,1336,613,1949
31/07/2018,#####,8,1340,645,1985
31/07/2018,#####,9,1395,698,2093
31/07/2018,#####,10,1431,811,2242
31/07/2018,#####,11,1512,909,2421
31/07/2018,#####,12,1560,892,2452
31/07/2018,#####,13,1667,931,2598
31/07/2018,#####,14,1595,940,2535
31/07/2018,#####,15,1918,903,2821
31/07/2018,#####,16,2455,845,3300
31/07/2018,#####,17,2600,835,3435
31/07/2018,#####,18,1924,632,2556
31/07/2018,#####,19,1328,490,1818
31/07/2018,#####,20,955,439,1394
31/07/2018,#####,21,762,464,1226
31/07/2018,#####,22,718,518,1236
31/07/2018,#####,23,704,416,1120
01/08/2018,#####,0,604,389,993
01/08/2018,#####,1,619,428,1047
01/08/2018,#####,2,544,424,968
01/08/2018,#####,3,487,380,867
01/08/2018,#####,4,488,344,832
01/08/2018,#####,5,510,328,838
01/08/2018,#####,6,510,347,857
01/08/2018,#####,7,790,414,1204
01/08/2018,#####,8,834,518,1352
01/08/2018,#####,9,906,566,1472
01/08/2018,#####,10,986,561,1547
01/08/2018,#####,11,1042,511,1553
01/08/2018,#####,12,1097,573,1670
01/08/2018,#####,13,1115,601,1716
01/08/2018,#####,14,1154,632,1786
01/08/2018,#####,15,1182,661,1843
01/08/2018,#####,16,1093,718,1811
01/08/2018,#####,17,961,658,1619
01/08/2018,#####,18,923,569,1492
01/08/2018,#####,19,800,496,1296
01/08/2018,#####,20,726,412,1138
01/08/2018,#####,21,698,405,1103
01/08/2018,#####,22,682,397,1079
01/08/2018,#####,23,579,376,955
02/08/2018,#####,0,552,299,851
02/08/2018,#####,1,555,256,811
02/08/2018,#####,2,592,255,847
02/08/2018,#####,3,552,260,812
02/08/2018,#####,4,520,255,775
02/08/2018,#####,5,393,255,648
02/08/2018,#####,6,562,279,841
02/08/2018,#####,7,683,398,1081
02/08/2018,#####,8,769,476,1245
02/08/2018,#####,9,815,539,1354
02/08/2018,#####,10,963,584,1547
02/08/2018,#####,11,1052,606,1658
02/08/2018,#####,12,1185,620,1805
02/08/2018,#####,13,1274,649,1923
02/08/2018,#####,14,1267,654,1921
02/08/2018,#####,15,1262,673,1935
02/08/2018,#####,16,1189,634,1823
02/08/2018,#####,17,998,565,1563
02/08/2018,#####,18,909,483,1392
02/08/2018,#####,19,788,418,1206
02/08/2018,#####,20,652,403,1055
02/08/2018,#####,21,607,369,976
02/08/2018,#####,22,615,340,955
02/08/2018,#####,23,628,261,889
03/08/2018,#####,0,681,262,943
03/08/2018,#####,1,716,259,975
03/08/2018,#####,2,684,259,943
03/08/2018,#####,3,665,272,937
03/08/2018,#####,4,683,254,937
03/08/2018,#####,5,672,256,928
03/08/2018,#####,6,854,338,1192
03/08/2018,#####,7,909,381,1290
03/08/2018,#####,8,1087,448,1535
03/08/2018,#####,9,1215,459,1674
03/08/2018,#####,10,1345,503,1848
03/08/2018,#####,11,1365,511,1876
03/08/2018,#####,12,1239,513,1752
03/08/2018,#####,13,1363,521,1884
03/08/2018,#####,14,1318,517,1835
03/08/2018,#####,15,1343,515,1858
03/08/2018,#####,16,1381,504,1885
03/08/2018,#####,17,1246,450,1696
03/08/2018,#####,18,1191,385,1576
03/08/2018,#####,19,1135,423,1558
03/08/2018,#####,20,1109,422,1531
03/08/2018,#####,21,968,412,1380
03/08/2018,#####,22,811,420,1231
03/08/2018,#####,23,800,430,1230
04/08/2018,#####,0,865,454,1319
04/08/2018,#####,1,1003,384,1387
04/08/2018,#####,2,1092,355,1447
04/08/2018,#####,3,1059,402,1461
04/08/2018,#####,4,1126,381,1507
04/08/2018,#####,5,1037,355,1392
04/08/2018,#####,6,896,322,1218
04/08/2018,#####,7,1148,341,1489
04/08/2018,#####,8,1309,387,1696
04/08/2018,#####,9,1440,463,1903
04/08/2018,#####,10,1598,542,2140
04/08/2018,#####,11,1822,563,2385
04/08/2018,#####,12,2089,638,2727
04/08/2018,#####,13,2271,666,2937
04/08/2018,#####,14,2356,704,3060
04/08/2018,#####,15,2456,694,3150
04/08/2018,#####,16,2259,635,2894
04/08/2018,#####,17,2134,606,2740
04/08/2018,#####,18,2256,656,2912
04/08/2018,#####,19,2411,652,3063
04/08/2018,#####,20,2266,636,2902
04/08/2018,#####,21,2138,741,2879
04/08/2018,#####,22,2391,680,3071
04/08/2018,#####,23,2624,762,3386
05/08/2018,#####,0,2416,649,3065
05/08/2018,#####,1,2404,675,3079
05/08/2018,#####,2,2492,737,3229
05/08/2018,#####,3,2896,725,3621
05/08/2018,#####,4,2983,760,3743
05/08/2018,#####,5,2787,836,3623
05/08/2018,#####,6,2737,782,3519
05/08/2018,#####,7,2902,797,3699
05/08/2018,#####,8,3110,895,4005
05/08/2018,#####,9,3150,923,4073
05/08/2018,#####,10,3098,887,3985
05/08/2018,#####,11,3050,888,3938
05/08/2018,#####,12,3027,1032,4059
05/08/2018,#####,13,3083,1117,4200
05/08/2018,#####,14,3240,1100,4340
05/08/2018,#####,15,3231,1170,4401
05/08/2018,#####,16,3215,1157,4372
05/08/2018,#####,17,3085,1103,4188
05/08/2018,#####,18,2555,991,3546
05/08/2018,#####,19,2378,940,3318
05/08/2018,#####,20,2109,866,2975
05/08/2018,#####,21,1886,751,2637
05/08/2018,#####,22,1690,679,2369
05/08/2018,#####,23,1678,623,2301
06/08/2018,#####,0,1731,573,2304
06/08/2018,#####,1,1591,504,2095
06/08/2018,#####,2,1531,519,2050
06/08/2018,#####,3,1424,483,1907
06/08/2018,#####,4,1353,443,1796
06/08/2018,#####,5,1249,421,1670
06/08/2018,#####,6,1269,423,1692
06/08/2018,#####,7,1272,431,1703
06/08/2018,#####,8,1325,546,1871
06/08/2018,#####,9,1421,536,1957
06/08/2018,#####,10,1518,558,2076
06/08/2018,#####,11,1643,574,2217
06/08/2018,#####,12,1838,614,2452
06/08/2018,#####,13,1966,690,2656
06/08/2018,#####,14,2080,704,2784
06/08/2018,#####,15,2250,669,2919
06/08/2018,#####,16,2192,620,2812
06/08/2018,#####,17,1936,535,2471
06/08/2018,#####,18,1624,464,2088
06/08/2018,#####,19,1358,441,1799
06/08/2018,#####,20,1067,416,1483
06/08/2018,#####,21,894,425,1319
06/08/2018,#####,22,760,428,1188
06/08/2018,#####,23,702,416,1118
07/08/2018,#####,0,646,430,1076
07/08/2018,#####,1,534,377,911
07/08/2018,#####,2,383,300,683
07/08/2018,#####,3,386,294,680
07/08/2018,#####,4,366,304,670
07/08/2018,#####,5,525,300,825
07/08/2018,#####,6,582,355,937
07/08/2018,#####,7,585,457,1042
07/08/2018,#####,8,666,497,1163
07/08/2018,#####,9,734,542,1276
07/08/2018,#####,10,826,567,1393
07/08/2018,#####,11,904,588,1492
07/08/2018,#####,12,1062,645,1707
07/08/2018,#####,13,1102,690,1792
07/08/2018,#####,14,1148,718,1866
07/08/2018,#####,15,1205,710,1915
07/08/2018,#####,16,1142,712,1854
07/08/2018,#####,17,1117,719,1836
07/08/2018,#####,18,1075,695,1770
07/08/2018,#####,19,1044,705,1749
07/08/2018,#####,20,1056,766,1822
07/08/2018,#####,21,1063,809,1872
07/08/2018,#####,22,1077,759,1836
07/08/2018,#####,23,1190,684,1874
08/08/2018,#####,0,1483,697,2180
08/08/2018,#####,1,1798,697,2495
08/08/2018,#####,2,1756,746,2502
08/08/2018,#####,3,1611,709,2320
08/08/2018,#####,4,1517,657,2174
08/08/2018,#####,5,1548,668,2216
08/08/2018,#####,6,1685,607,2292
08/08/2018,#####,7,1515,596,2111
08/08/2018,#####,8,1455,650,2105
08/08/2018,#####,9,1329,699,2028
08/08/2018,#####,10,1175,689,1864
08/08/2018,#####,11,1067,562,1629
08/08/2018,#####,12,1374,515,1889
08/08/2018,#####,13,1706,505,2211
08/08/2018,#####,14,1945,441,2386
08/08/2018,#####,15,2397,449,2846
08/08/2018,#####,16,2527,501,3028
08/08/2018,#####,17,2105,455,2560
08/08/2018,#####,18,1936,396,2332
08/08/2018,#####,19,1634,601,2235
08/08/2018,#####,20,2106,740,2846
08/08/2018,#####,21,1857,713,2570
08/08/2018,#####,22,1655,656,2311
08/08/2018,#####,23,1572,603,2175
09/08/2018,#####,0,1360,563,1923
09/08/2018,#####,1,1160,467,1627
09/08/2018,#####,2,936,350,1286
09/08/2018,#####,3,769,299,1068
09/08/2018,#####,4,713,282,995
09/08/2018,#####,5,635,262,897
09/08/2018,#####,6,708,285,993
09/08/2018,#####,7,790,408,1198
09/08/2018,#####,8,856,453,1309
09/08/2018,#####,9,1010,540,1550
09/08/2018,#####,10,1095,570,1665
09/08/2018,#####,11,1108,605,1713
09/08/2018,#####,12,1067,611,1678
09/08/2018,#####,13,1069,624,1693
09/08/2018,#####,14,1076,548,1624
09/08/2018,#####,15,1078,504,1582
09/08/2018,#####,16,1101,562,1663
09/08/2018,#####,17,1129,679,1808
09/08/2018,#####,18,1205,880,2085
09/08/2018,#####,19,1534,877,2411
09/08/2018,#####,20,1809,866,2675
09/08/2018,#####,21,1987,759,2746
09/08/2018,#####,22,2289,576,2865
09/08/2018,#####,23,2606,597,3203
10/08/2018,#####,0,2884,701,3585
10/08/2018,#####,1,2887,838,3725
10/08/2018,#####,2,2854,935,3789
10/08/2018,#####,3,2962,1039,4001
10/08/2018,#####,4,3139,1085,4224
10/08/2018,#####,5,3410,1117,4527
10/08/2018,#####,6,3716,1176,4892
10/08/2018,#####,7,3900,1224,5124
10/08/2018,#####,8,4060,1251,5311
10/08/2018,#####,9,4344,1288,5632
10/08/2018,#####,10,4528,1323,5851
10/08/2018,#####,11,4596,1334,5930
10/08/2018,#####,12,4727,1351,6078
10/08/2018,#####,13,4436,1375,5811
10/08/2018,#####,14,4260,1367,5627
10/08/2018,#####,15,3943,1239,5182
10/08/2018,#####,16,3721,1118,4839
10/08/2018,#####,17,2989,875,3864
10/08/2018,#####,18,2630,718,3348
10/08/2018,#####,19,2060,697,2757
10/08/2018,#####,20,1659,559,2218
10/08/2018,#####,21,1341,470,1811
10/08/2018,#####,22,1009,393,1402
10/08/2018,#####,23,1169,338,1507
11/08/2018,#####,0,1195,317,1512
11/08/2018,#####,1,1112,348,1460
11/08/2018,#####,2,873,486,1359
11/08/2018,#####,3,837,617,1454
11/08/2018,#####,4,963,634,1597
11/08/2018,#####,5,1126,710,1836
11/08/2018,#####,6,1279,766,2045
11/08/2018,#####,7,1395,809,2204
11/08/2018,#####,8,1449,893,2342
11/08/2018,#####,9,1497,948,2445
11/08/2018,#####,10,1635,970,2605
11/08/2018,#####,11,1750,1032,2782
11/08/2018,#####,12,2067,1054,3121
11/08/2018,#####,13,2280,1101,3381
11/08/2018,#####,14,2518,1173,3691
11/08/2018,#####,15,2620,1145,3765
11/08/2018,#####,16,2758,1089,3847
11/08/2018,#####,17,2739,1099,3838
11/08/2018,#####,18,3279,1086,4365
11/08/2018,#####,19,3093,994,4087
11/08/2018,#####,20,2587,959,3546
11/08/2018,#####,21,2378,966,3344
11/08/2018,#####,22,2376,985,3361
11/08/2018,#####,23,2348,975,3323
12/08/2018,#####,0,2317,958,3275
12/08/2018,#####,1,2220,896,3116
12/08/2018,#####,2,2093,840,2933
12/08/2018,#####,3,1951,727,2678
12/08/2018,#####,4,1754,631,2385
12/08/2018,#####,5,1584,540,2124
12/08/2018,#####,6,1440,523,1963
12/08/2018,#####,7,1350,550,1900
12/08/2018,#####,8,1336,646,1982
12/08/2018,#####,9,1337,765,2102
12/08/2018,#####,10,1414,776,2190
12/08/2018,#####,11,1392,730,2122
12/08/2018,#####,12,1294,662,1956
12/08/2018,#####,13,1336,555,1891
12/08/2018,#####,14,1251,474,1725
12/08/2018,#####,15,1341,385,1726
12/08/2018,#####,16,1244,412,1656
12/08/2018,#####,17,1108,316,1424
12/08/2018,#####,18,1089,281,1370
12/08/2018,#####,19,967,384,1351
12/08/2018,#####,20,1062,393,1455
12/08/2018,#####,21,1053,388,1441
12/08/2018,#####,22,1046,416,1462
12/08/2018,#####,23,1034,348,1382
13/08/2018,#####,0,1001,298,1299
13/08/2018,#####,1,991,281,1272
13/08/2018,#####,2,936,313,1249
13/08/2018,#####,3,940,356,1296
13/08/2018,#####,4,958,372,1330
13/08/2018,#####,5,1088,373,1461
13/08/2018,#####,6,1175,446,1621
13/08/2018,#####,7,1403,423,1826
13/08/2018,#####,8,1611,487,2098
13/08/2018,#####,9,1725,486,2211
13/08/2018,#####,10,1707,443,2150
13/08/2018,#####,11,1650,501,2151
13/08/2018,#####,12,1495,590,2085
13/08/2018,#####,13,1300,612,1912
13/08/2018,#####,14,1140,601,1741
13/08/2018,#####,15,987,615,1602
13/08/2018,#####,16,886,665,1551
13/08/2018,#####,17,897,696,1593
13/08/2018,#####,18,901,522,1423
13/08/2018,#####,19,957,455,1412
13/08/2018,#####,20,1056,470,1526
13/08/2018,#####,21,1098,474,1572
13/08/2018,#####,22,1082,494,1576
13/08/2018,#####,23,850,526,1376
14/08/2018,#####,0,760,422,1182
14/08/2018,#####,1,754,419,1173
14/08/2018,#####,2,829,441,1270
14/08/2018,#####,3,777,430,1207
14/08/2018,#####,4,662,434,1096
14/08/2018,#####,5,705,401,1106
14/08/2018,#####,6,831,390,1221
14/08/2018,#####,7,949,503,1452
14/08/2018,#####,8,873,689,1562
14/08/2018,#####,9,851,735,1586
14/08/2018,#####,10,932,773,1705
14/08/2018,#####,11,860,652,1512
14/08/2018,#####,12,807,690,1497
14/08/2018,#####,13,984,819,1803
14/08/2018,#####,14,1104,762,1866
14/08/2018,#####,15,1179,688,1867
14/08/2018,#####,16,1202,679,1881
14/08/2018,#####,17,1156,622,1778
14/08/2018,#####,18,1136,694,1830
14/08/2018,#####,19,1072,773,1845
14/08/2018,#####,20,1105,595,1700
14/08/2018,#####,21,1103,489,1592
14/08/2018,#####,22,1145,449,1594
14/08/2018,#####,23,1201,422,1623
15/08/2018,#####,0,1028,420,1448
15/08/2018,#####,1,1019,465,1484
15/08/2018,#####,2,1024,578,1602
15/08/2018,#####,3,950,667,1617
15/08/2018,#####,4,882,549,1431
15/08/2018,#####,5,871,489,1360
15/08/2018,#####,6,868,438,1306
15/08/2018,#####,7,839,374,1213
15/08/2018,#####,8,989,406,1395
15/08/2018,#####,9,1050,488,1538
15/08/2018,#####,10,1216,534,1750
15/08/2018,#####,11,1246,578,1824
15/08/2018,#####,12,1423,559,1982
15/08/2018,#####,13,1456,540,1996
15/08/2018,#####,14,1521,498,2019
15/08/2018,#####,15,1716,490,2206
15/08/2018,#####,16,1645,535,2180
15/08/2018,#####,17,1614,487,2101
15/08/2018,#####,18,1438,438,1876
15/08/2018,#####,19,1374,423,1797
15/08/2018,#####,20,1235,447,1682
15/08/2018,#####,21,1226,393,1619
15/08/2018,#####,22,1240,345,1585
15/08/2018,#####,23,1245,279,1524
16/08/2018,#####,0,1360,287,1647
16/08/2018,#####,1,1392,297,1689
16/08/2018,#####,2,1394,328,1722
16/08/2018,#####,3,1446,365,1811
16/08/2018,#####,4,1498,381,1879
16/08/2018,#####,5,1722,384,2106
16/08/2018,#####,6,1853,405,2258
16/08/2018,#####,7,2214,450,2664
16/08/2018,#####,8,2522,531,3053
16/08/2018,#####,9,2837,603,3440
16/08/2018,#####,10,3111,748,3859
16/08/2018,#####,11,3229,994,4223
16/08/2018,#####,12,3311,876,4187
16/08/2018,#####,13,3267,878,4145
16/08/2018,#####,14,3264,837,4101
16/08/2018,#####,15,3143,787,3930
16/08/2018,#####,16,3131,701,3832
16/08/2018,#####,17,3092,525,3617
16/08/2018,#####,18,3017,420,3437
16/08/2018,#####,19,2767,370,3137
16/08/2018,#####,20,2329,351,2680
16/08/2018,#####,21,1871,343,2214
16/08/2018,#####,22,1668,297,1965
16/08/2018,#####,23,1513,289,1802
17/08/2018,#####,0,1336,285,1621
17/08/2018,#####,1,1213,302,1515
17/08/2018,#####,2,1013,314,1327
17/08/2018,#####,3,853,316,1169
17/08/2018,#####,4,968,300,1268
17/08/2018,#####,5,1033,318,1351
17/08/2018,#####,6,1134,388,1522
17/08/2018,#####,7,1268,428,1696
17/08/2018,#####,8,1318,482,1800
17/08/2018,#####,9,1324,447,1771
17/08/2018,#####,10,1475,455,1930
17/08/2018,#####,11,1613,486,2099
17/08/2018,#####,12,1687,469,2156
17/08/2018,#####,13,1850,440,2290
17/08/2018,#####,14,1889,429,2318
17/08/2018,#####,15,1924,428,2352
17/08/2018,#####,16,1927,413,2340
17/08/2018,#####,17,1932,423,2355
17/08/2018,#####,18,1741,421,2162
17/08/2018,#####,19,1500,373,1873
17/08/2018,#####,20,1224,403,1627
17/08/2018,#####,21,1228,348,1576
17/08/2018,#####,22,1200,326,1526
17/08/2018,#####,23,1238,330,1568
18/08/2018,#####,0,1268,320,1588
18/08/2018,#####,1,1306,306,1612
18/08/2018,#####,2,1531,281,1812
18/08/2018,#####,3,1662,272,1934
18/08/2018,#####,4,1675,286,1961
18/08/2018,#####,5,1771,329,2100
18/08/2018,#####,6,1889,362,2251
18/08/2018,#####,7,1995,422,2417
18/08/2018,#####,8,2205,537,2742
18/08/2018,#####,9,2728,625,3353
18/08/2018,#####,10,3035,658,3693
18/08/2018,#####,11,3357,716,4073
18/08/2018,#####,12,3760,742,4502
18/08/2018,#####,13,3937,775,4712
18/08/2018,#####,14,4030,770,4800
18/08/2018,#####,15,3886,756,4642
18/08/2018,#####,16,3788,702,4490
18/08/2018,#####,17,3708,623,4331
18/08/2018,#####,18,3432,597,4029
18/08/2018,#####,19,3027,619,3646
18/08/2018,#####,20,2704,593,3297
18/08/2018,#####,21,2395,601,2996
18/08/2018,#####,22,2375,629,3004
18/08/2018,#####,23,2216,629,2845
19/08/2018,#####,0,2146,667,2813
19/08/2018,#####,1,1951,685,2636
19/08/2018,#####,2,1826,602,2428
19/08/2018,#####,3,1730,515,2245
19/08/2018,#####,4,1712,487,2199
19/08/2018,#####,5,1593,520,2113
19/08/2018,#####,6,1409,554,1963
19/08/2018,#####,7,1344,527,1871
19/08/2018,#####,8,1205,497,1702
19/08/2018,#####,9,1214,523,1737
19/08/2018,#####,10,1289,517,1806
19/08/2018,#####,11,1264,585,1849
19/08/2018,#####,12,1219,589,1808
19/08/2018,#####,13,1328,546,1874
19/08/2018,#####,14,1411,490,1901
19/08/2018,#####,15,1552,488,2040
19/08/2018,#####,16,1616,453,2069
19/08/2018,#####,17,1716,376,2092
19/08/2018,#####,18,1898,338,2236
19/08/2018,#####,19,1982,330,2312
19/08/2018,#####,20,2011,308,2319
19/08/2018,#####,21,2144,345,2489
19/08/2018,#####,22,2140,388,2528
19/08/2018,#####,23,2052,454,2506
20/08/2018,#####,0,1954,557,2511
20/08/2018,#####,1,1763,635,2398
20/08/2018,#####,2,1645,699,2344
20/08/2018,#####,3,1588,726,2314
20/08/2018,#####,4,1596,772,2368
20/08/2018,#####,5,1606,754,2360
20/08/2018,#####,6,1872,748,2620
20/08/2018,#####,7,2110,782,2892
20/08/2018,#####,8,2470,826,3296
20/08/2018,#####,9,2964,917,3881
20/08/2018,#####,10,3171,961,4132
20/08/2018,#####,11,3270,1049,4319
20/08/2018,#####,12,3343,1122,4465
20/08/2018,#####,13,3334,1094,4428
20/08/2018,#####,14,3403,1188,4591
20/08/2018,#####,15,3432,1195,4627
20/08/2018,#####,16,3411,1153,4564
20/08/2018,#####,17,3246,1086,4332
20/08/2018,#####,18,3021,1001,4022
20/08/2018,#####,19,2617,904,3521
20/08/2018,#####,20,2130,745,2875
20/08/2018,#####,21,1964,671,2635
20/08/2018,#####,22,1873,626,2499
20/08/2018,#####,23,1763,628,2391
21/08/2018,#####,0,1612,582,2194
21/08/2018,#####,1,1557,592,2149
21/08/2018,#####,2,1541,581,2122
21/08/2018,#####,3,1352,566,1918
21/08/2018,#####,4,1247,504,1751
21/08/2018,#####,5,1119,464,1583
21/08/2018,#####,6,1134,532,1666
21/08/2018,#####,7,1150,568,1718
21/08/2018,#####,8,1264,621,1885
21/08/2018,#####,9,1331,641,1972
21/08/2018,#####,10,1409,638,2047
21/08/2018,#####,11,1427,553,1980
21/08/2018,#####,12,1342,562,1904
21/08/2018,#####,13,1224,569,1793
21/08/2018,#####,14,1199,619,1818
21/08/2018,#####,15,1173,598,1771
21/08/2018,#####,16,1105,491,1596
21/08/2018,#####,17,1015,500,1515
21/08/2018,#####,18,886,448,1334
21/08/2018,#####,19,835,393,1228
21/08/2018,#####,20,770,368,1138
21/08/2018,#####,21,670,357,1027
21/08/2018,#####,22,466,349,815
21/08/2018,#####,23,548,293,841
22/08/2018,#####,0,727,330,1057
22/08/2018,#####,1,900,345,1245
22/08/2018,#####,2,1073,359,1432
22/08/2018,#####,3,1390,353,1743
22/08/2018,#####,4,1684,371,2055
22/08/2018,#####,5,1839,376,2215
22/08/2018,#####,6,1888,400,2288
22/08/2018,#####,7,1903,421,2324
22/08/2018,#####,8,2060,507,2567
22/08/2018,#####,9,2082,596,2678
22/08/2018,#####,10,2429,658,3087
22/08/2018,#####,11,2725,691,3416
22/08/2018,#####,12,3007,716,3723
22/08/2018,#####,13,3091,746,3837
22/08/2018,#####,14,3269,720,3989
22/08/2018,#####,15,3235,664,3899
22/08/2018,#####,16,3103,616,3719
22/08/2018,#####,17,2983,561,3544
22/08/2018,#####,18,2690,489,3179
22/08/2018,#####,19,2213,426,2639
22/08/2018,#####,20,1867,401,2268
22/08/2018,#####,21,1752,432,2184
22/08/2018,#####,22,1671,508,2179
22/08/2018,#####,23,1407,534,1941
23/08/2018,#####,0,1252,494,1746
23/08/2018,#####,1,1064,438,1502
23/08/2018,#####,2,1060,369,1429
23/08/2018,#####,3,1008,331,1339
23/08/2018,#####,4,936,303,1239
23/08/2018,#####,5,1002,355,1357
23/08/2018,#####,6,985,380,1365
23/08/2018,#####,7,1100,413,1513
23/08/2018,#####,8,1263,466,1729
23/08/2018,#####,9,1353,528,1881
23/08/2018,#####,10,1436,573,2009
23/08/2018,#####,11,1505,653,2158
23/08/2018,#####,12,1745,634,2379
23/08/2018,#####,13,1916,672,2588
23/08/2018,#####,14,2102,686,2788
23/08/2018,#####,15,2186,589,2775
23/08/2018,#####,16,2246,535,2781
23/08/2018,#####,17,2032,547,2579
23/08/2018,#####,18,1736,628,2364
23/08/2018,#####,19,1472,517,1989
23/08/2018,#####,20,1322,433,1755
23/08/2018,#####,21,1303,447,1750
23/08/2018,#####,22,1208,444,1652
23/08/2018,#####,23,1186,373,1559
24/08/2018,#####,0,1239,371,1610
24/08/2018,#####,1,1252,453,1705
24/08/2018,#####,2,1123,495,1618
24/08/2018,#####,3,1097,520,1617
24/08/2018,#####,4,1091,610,1701
24/08/2018,#####,5,1062,542,1604
24/08/2018,#####,6,1214,527,1741
24/08/2018,#####,7,1335,423,1758
24/08/2018,#####,8,1593,515,2108
24/08/2018,#####,9,1742,787,2529
24/08/2018,#####,10,1853,818,2671
24/08/2018,#####,11,2032,875,2907
24/08/2018,#####,12,2314,1066,3380
24/08/2018,#####,13,2668,1068,3736
24/08/2018,#####,14,2590,951,3541
24/08/2018,#####,15,2569,858,3427
24/08/2018,#####,16,2438,972,3410
24/08/2018,#####,17,2286,1008,3294
24/08/2018,#####,18,2141,909,3050
24/08/2018,#####,19,1890,809,2699
24/08/2018,#####,20,1576,816,2392
24/08/2018,#####,21,1551,829,2380
24/08/2018,#####,22,1630,786,2416
24/08/2018,#####,23,1573,651,2224
25/08/2018,#####,0,1301,694,1995
25/08/2018,#####,1,1191,801,1992
25/08/2018,#####,2,1179,776,1955
25/08/2018,#####,3,1194,803,1997
25/08/2018,#####,4,1281,750,2031
25/08/2018,#####,5,1219,649,1868
25/08/2018,#####,6,1193,584,1777
25/08/2018,#####,7,1125,599,1724
25/08/2018,#####,8,1220,570,1790
25/08/2018,#####,9,1178,690,1868
25/08/2018,#####,10,1209,672,1881
25/08/2018,#####,11,1205,622,1827
25/08/2018,#####,12,1204,601,1805
25/08/2018,#####,13,1087,614,1701
25/08/2018,#####,14,903,670,1573
25/08/2018,#####,15,838,476,1314
25/08/2018,#####,16,896,481,1377
25/08/2018,#####,17,966,510,1476
25/08/2018,#####,18,1056,398,1454
25/08/2018,#####,19,872,458,1330
25/08/2018,#####,20,952,557,1509
25/08/2018,#####,21,973,585,1558
25/08/2018,#####,22,1196,645,1841
25/08/2018,#####,23,1333,672,2005
26/08/2018,#####,0,1216,683,1899
26/08/2018,#####,1,1236,698,1934
26/08/2018,#####,2,1285,598,1883
26/08/2018,#####,3,1474,637,2111
26/08/2018,#####,4,1500,685,2185
26/08/2018,#####,5,1566,696,2262
26/08/2018,#####,6,1473,717,2190
26/08/2018,#####,7,1567,697,2264
26/08/2018,#####,8,1677,731,2408
26/08/2018,#####,9,1901,871,2772
26/08/2018,#####,10,2105,908,3013
26/08/2018,#####,11,2306,913,3219
26/08/2018,#####,12,2271,929,3200
26/08/2018,#####,13,2194,813,3007
26/08/2018,#####,14,2164,803,2967
26/08/2018,#####,15,1993,713,2706
26/08/2018,#####,16,1687,655,2342
26/08/2018,#####,17,1431,576,2007
26/08/2018,#####,18,1295,489,1784
26/08/2018,#####,19,1083,353,1436
26/08/2018,#####,20,1047,303,1350
26/08/2018,#####,21,1190,302,1492
26/08/2018,#####,22,1297,285,1582
26/08/2018,#####,23,1443,296,1739
27/08/2018,#####,0,1560,382,1942
27/08/2018,#####,1,1734,531,2265
27/08/2018,#####,2,1890,594,2484
27/08/2018,#####,3,2198,686,2884
27/08/2018,#####,4,2448,857,3305
27/08/2018,#####,5,2600,931,3531
27/08/2018,#####,6,2886,841,3727
27/08/2018,#####,7,3258,948,4206
27/08/2018,#####,8,2834,990,3824
27/08/2018,#####,9,3061,1053,4114
27/08/2018,#####,10,3189,1040,4229
27/08/2018,#####,11,2926,1025,3951
27/08/2018,#####,12,2697,1017,3714
27/08/2018,#####,13,2748,993,3741
27/08/2018,#####,14,2872,975,3847
27/08/2018,#####,15,2801,1002,3803
27/08/2018,#####,16,2887,925,3812
27/08/2018,#####,17,2799,830,3629
27/08/2018,#####,18,2782,902,3684
27/08/2018,#####,19,2596,864,3460
27/08/2018,#####,20,2218,823,3041
27/08/2018,#####,21,2148,846,2994
27/08/2018,#####,22,2120,785,2905
27/08/2018,#####,23,1895,756,2651
28/08/2018,#####,0,1886,696,2582
28/08/2018,#####,1,1939,582,2521
28/08/2018,#####,2,1739,586,2325
28/08/2018,#####,3,1760,509,2269
28/08/2018,#####,4,1776,542,2318
28/08/2018,#####,5,1745,495,2240
28/08/2018,#####,6,1635,510,2145
28/08/2018,#####,7,1658,592,2250
28/08/2018,#####,8,1625,597,2222
28/08/2018,#####,9,1418,580,1998
28/08/2018,#####,10,1630,705,2335
28/08/2018,#####,11,1762,704,2466
28/08/2018,#####,12,1737,684,2421
28/08/2018,#####,13,1707,641,2348
28/08/2018,#####,14,1596,618,2214
28/08/2018,#####,15,1589,589,2178
28/08/2018,#####,16,1499,506,2005
28/08/2018,#####,17,1364,480,1844
28/08/2018,#####,18,1174,461,1635
28/08/2018,#####,19,995,433,1428
28/08/2018,#####,20,939,405,1344
28/08/2018,#####,21,874,386,1260
28/08/2018,#####,22,756,363,1119
28/08/2018,#####,23,659,258,917
29/08/2018,#####,0,658,246,904
29/08/2018,#####,1,636,236,872
29/08/2018,#####,2,647,237,884
29/08/2018,#####,3,656,237,893
29/08/2018,#####,4,730,238,968
29/08/2018,#####,5,740,256,996
29/08/2018,#####,6,866,364,1230
29/08/2018,#####,7,981,395,1376
29/08/2018,#####,8,1074,407,1481
29/08/2018,#####,9,1156,464,1620
29/08/2018,#####,10,1253,548,1801
29/08/2018,#####,11,1285,653,1938
29/08/2018,#####,12,1278,678,1956
29/08/2018,#####,13,1404,673,2077
29/08/2018,#####,14,1459,712,2171
29/08/2018,#####,15,1462,717,2179
29/08/2018,#####,16,1367,705,2072
29/08/2018,#####,17,1299,741,2040
29/08/2018,#####,18,1119,779,1898
29/08/2018,#####,19,1022,780,1802
29/08/2018,#####,20,1071,746,1817
29/08/2018,#####,21,1107,729,1836
29/08/2018,#####,22,1044,583,1627
29/08/2018,#####,23,915,493,1408
30/08/2018,#####,0,887,440,1327
30/08/2018,#####,1,880,387,1267
30/08/2018,#####,2,849,335,1184
30/08/2018,#####,3,758,295,1053
30/08/2018,#####,4,860,281,1141
30/08/2018,#####,5,888,265,1153
30/08/2018,#####,6,1004,282,1286
30/08/2018,#####,7,1223,390,1613
30/08/2018,#####,8,1394,440,1834
30/08/2018,#####,9,1595,507,2102
30/08/2018,#####,10,1715,557,2272
30/08/2018,#####,11,1831,550,2381
30/08/2018,#####,12,1847,502,2349
30/08/2018,#####,13,1924,473,2397
30/08/2018,#####,14,1990,453,2443
30/08/2018,#####,15,2160,461,2621
30/08/2018,#####,16,2334,476,2810
30/08/2018,#####,17,2388,518,2906
30/08/2018,#####,18,2296,592,2888
30/08/2018,#####,19,2044,644,2688
30/08/2018,#####,20,1808,678,2486
30/08/2018,#####,21,1744,653,2397
30/08/2018,#####,22,1635,529,2164
30/08/2018,#####,23,1565,545,2110
31/08/2018,#####,0,1542,669,2211
31/08/2018,#####,1,1460,620,2080
31/08/2018,#####,2,1388,589,1977
31/08/2018,#####,3,1386,601,1987
31/08/2018,#####,4,1351,592,1943
31/08/2018,#####,5,1481,572,2053
31/08/2018,#####,6,1566,568,2134
31/08/2018,#####,7,1802,597,2399
31/08/2018,#####,8,1833,603,2436
31/08/2018,#####,9,1898,649,2547
31/08/2018,#####,10,1933,737,2670
31/08/2018,#####,11,1848,674,2522
31/08/2018,#####,12,2017,735,2752
31/08/2018,#####,13,1964,729,2693
31/08/2018,#####,14,1870,637,2507
31/08/2018,#####,15,1765,592,2357
31/08/2018,#####,16,1701,575,2276
31/08/2018,#####,17,1603,553,2156
31/08/2018,#####,18,1468,513,1981
31/08/2018,#####,19,1315,449,1764
31/08/2018,#####,20,1211,447,1658
31/08/2018,#####,21,1042,438,1480
31/08/2018,#####,22,920,459,1379
31/08/2018,#####,23,804,383,1187
01/09/2018,#####,0,778,339,1117
01/09/2018,#####,1,697,317,1014
01/09/2018,#####,2,699,314,1013
01/09/2018,#####,3,672,297,969
01/09/2018,#####,4,664,323,987
01/09/2018,#####,5,695,349,1044
01/09/2018,#####,6,629,335,964
01/09/2018,#####,7,699,378,1077
01/09/2018,#####,8,795,419,1214
01/09/2018,#####,9,871,434,1305
01/09/2018,#####,10,922,440,1362
01/09/2018,#####,11,804,436,1240
01/09/2018,#####,12,801,430,1231
01/09/2018,#####,13,810,461,1271
01/09/2018,#####,14,709,473,1182
01/09/2018,#####,15,819,455,1274
01/09/2018,#####,16,774,447,1221
01/09/2018,#####,17,828,395,1223
01/09/2018,#####,18,829,335,1164
01/09/2018,#####,19,762,292,1054
01/09/2018,#####,20,728,264,992
01/09/2018,#####,21,686,256,942
01/09/2018,#####,22,584,250,834
01/09/2018,#####,23,545,246,791
02/09/2018,#####,0,597,253,850
02/09/2018,#####,1,549,252,801
02/09/2018,#####,2,465,247,712
02/09/2018,#####,3,397,254,651
02/09/2018,#####,4,390,255,645
02/09/2018,#####,5,397,255,652
02/09/2018,#####,6,399,260,659
02/09/2018,#####,7,467,298,765
02/09/2018,#####,8,573,329,902
02/09/2018,#####,9,820,375,1195
02/09/2018,#####,10,878,410,1288
02/09/2018,#####,11,934,415,1349
02/09/2018,#####,12,966,450,1416
02/09/2018,#####,13,967,470,1437
02/09/2018,#####,14,901,486,1387
02/09/2018,#####,15,940,502,1442
02/09/2018,#####,16,920,493,1413
02/09/2018,#####,17,869,493,1362
02/09/2018,#####,18,852,555,1407
02/09/2018,#####,19,789,585,1374
02/09/2018,#####,20,771,592,1363
02/09/2018,#####,21,815,586,1401
02/09/2018,#####,22,844,558,1402
02/09/2018,#####,23,832,510,1342
03/09/2018,#####,0,713,524,1237
03/09/2018,#####,1,728,537,1265
03/09/2018,#####,2,699,533,1232
03/09/2018,#####,3,693,569,1262
03/09/2018,#####,4,679,592,1271
03/09/2018,#####,5,802,612,1414
03/09/2018,#####,6,1012,632,1644
03/09/2018,#####,7,1221,762,1983
03/09/2018,#####,8,1255,771,2026
03/09/2018,#####,9,1291,818,2109
03/09/2018,#####,10,1316,884,2200
03/09/2018,#####,11,1470,932,2402
03/09/2018,#####,12,1422,974,2396
03/09/2018,#####,13,1378,998,2376
03/09/2018,#####,14,1218,934,2152
03/09/2018,#####,15,1193,921,2114
03/09/2018,#####,16,1132,935,2067
03/09/2018,#####,17,1028,925,1953
03/09/2018,#####,18,1054,840,1894
03/09/2018,#####,19,921,722,1643
03/09/2018,#####,20,902,659,1561
03/09/2018,#####,21,827,641,1468
03/09/2018,#####,22,806,533,1339
03/09/2018,#####,23,735,470,1205
04/09/2018,#####,0,765,412,1177
04/09/2018,#####,1,712,351,1063
04/09/2018,#####,2,600,361,961
04/09/2018,#####,3,561,388,949
04/09/2018,#####,4,544,397,941
04/09/2018,#####,5,503,411,914
04/09/2018,#####,6,714,480,1194
04/09/2018,#####,7,885,502,1387
04/09/2018,#####,8,923,498,1421
04/09/2018,#####,9,994,521,1515
04/09/2018,#####,10,1127,570,1697
04/09/2018,#####,11,1227,615,1842
04/09/2018,#####,12,1152,614,1766
04/09/2018,#####,13,1149,631,1780
04/09/2018,#####,14,1093,624,1717
04/09/2018,#####,15,1103,585,1688
04/09/2018,#####,16,1026,553,1579
04/09/2018,#####,17,986,496,1482
04/09/2018,#####,18,890,441,1331
04/09/2018,#####,19,838,404,1242
04/09/2018,#####,20,831,396,1227
04/09/2018,#####,21,718,382,1100
04/09/2018,#####,22,631,360,991
04/09/2018,#####,23,595,297,892
05/09/2018,#####,0,619,290,909
05/09/2018,#####,1,666,282,948
05/09/2018,#####,2,433,275,708
05/09/2018,#####,3,425,278,703
05/09/2018,#####,4,539,278,817
05/09/2018,#####,5,569,282,851
05/09/2018,#####,6,670,369,1039
05/09/2018,#####,7,737,413,1150
05/09/2018,#####,8,813,448,1261
05/09/2018,#####,9,883,479,1362
05/09/2018,#####,10,928,525,1453
05/09/2018,#####,11,962,596,1558
05/09/2018,#####,12,1024,614,1638
05/09/2018,#####,13,1023,574,1597
05/09/2018,#####,14,962,530,1492
05/09/2018,#####,15,1054,553,1607
05/09/2018,#####,16,951,520,1471
05/09/2018,#####,17,881,519,1400
05/09/2018,#####,18,804,475,1279
05/09/2018,#####,19,802,445,1247
05/09/2018,#####,20,932,528,1460
05/09/2018,#####,21,794,480,1274
05/09/2018,#####,22,791,430,1221
05/09/2018,#####,23,757,425,1182
06/09/2018,#####,0,761,374,1135
06/09/2018,#####,1,650,364,1014
06/09/2018,#####,2,645,359,1004
06/09/2018,#####,3,620,353,973
06/09/2018,#####,4,609,344,953
06/09/2018,#####,5,689,344,1033
06/09/2018,#####,6,976,469,1445
06/09/2018,#####,7,1110,506,1616
06/09/2018,#####,8,1261,564,1825
06/09/2018,#####,9,1171,644,1815
06/09/2018,#####,10,1553,736,2289
06/09/2018,#####,11,1817,724,2541
06/09/2018,#####,12,2073,767,2840
06/09/2018,#####,13,2164,813,2977
06/09/2018,#####,14,2176,897,3073
06/09/2018,#####,15,2155,932,3087
06/09/2018,#####,16,2128,948,3076
06/09/2018,#####,17,1913,923,2836
06/09/2018,#####,18,1908,890,2798
06/09/2018,#####,19,1894,889,2783
06/09/2018,#####,20,2080,856,2936
06/09/2018,#####,21,2297,781,3078
06/09/2018,#####,22,2610,747,3357
06/09/2018,#####,23,2614,735,3349
07/09/2018,#####,0,2444,712,3156
07/09/2018,#####,1,2537,647,3184
07/09/2018,#####,2,2530,592,3122
07/09/2018,#####,3,2433,572,3005
07/09/2018,#####,4,2240,533,2773
07/09/2018,#####,5,2146,470,2616
07/09/2018,#####,6,2054,441,2495
07/09/2018,#####,7,2027,557,2584
07/09/2018,#####,8,2033,600,2633
07/09/2018,#####,9,1970,585,2555
07/09/2018,#####,10,1914,612,2526
07/09/2018,#####,11,1850,571,2421
07/09/2018,#####,12,1530,551,2081
07/09/2018,#####,13,1476,600,2076
07/09/2018,#####,14,1489,538,2027
07/09/2018,#####,15,1520,543,2063
07/09/2018,#####,16,1726,542,2268
07/09/2018,#####,17,1743,515,2258
07/09/2018,#####,18,1771,829,2600
07/09/2018,#####,19,1641,907,2548
07/09/2018,#####,20,1501,749,2250
07/09/2018,#####,21,1703,702,2405
07/09/2018,#####,22,1479,706,2185
07/09/2018,#####,23,1535,688,2223
08/09/2018,#####,0,1701,584,2285
08/09/2018,#####,1,1760,597,2357
08/09/2018,#####,2,1722,661,2383
08/09/2018,#####,3,1719,729,2448
08/09/2018,#####,4,1817,850,2667
08/09/2018,#####,5,1958,904,2862
08/09/2018,#####,6,2053,895,2948
08/09/2018,#####,7,2266,904,3170
08/09/2018,#####,8,2339,983,3322
08/09/2018,#####,9,2488,1087,3575
08/09/2018,#####,10,2453,1098,3551
08/09/2018,#####,11,2566,1104,3670
08/09/2018,#####,12,2736,1098,3834
08/09/2018,#####,13,2797,1103,3900
08/09/2018,#####,14,2860,1018,3878
08/09/2018,#####,15,3221,1066,4287
08/09/2018,#####,16,3234,935,4169
08/09/2018,#####,17,3305,849,4154
08/09/2018,#####,18,2995,745,3740
08/09/2018,#####,19,2687,595,3282
08/09/2018,#####,20,2362,523,2885
08/09/2018,#####,21,2262,459,2721
08/09/2018,#####,22,2356,417,2773
08/09/2018,#####,23,2377,498,2875
09/09/2018,#####,0,2579,501,3080
09/09/2018,#####,1,2432,518,2950
09/09/2018,#####,2,2274,568,2842
09/09/2018,#####,3,2376,543,2919
09/09/2018,#####,4,2350,534,2884
09/09/2018,#####,5,2142,476,2618
09/09/2018,#####,6,2038,477,2515
09/09/2018,#####,7,1855,510,2365
09/09/2018,#####,8,1798,537,2335
09/09/2018,#####,9,1826,631,2457
09/09/2018,#####,10,1924,691,2615
09/09/2018,#####,11,2034,674,2708
09/09/2018,#####,12,2000,675,2675
09/09/2018,#####,13,2010,648,2658
09/09/2018,#####,14,2019,647,2666
09/09/2018,#####,15,2251,596,2847
09/09/2018,#####,16,2182,510,2692
09/09/2018,#####,17,1981,434,2415
09/09/2018,#####,18,1741,420,2161
09/09/2018,#####,19,1745,390,2135
09/09/2018,#####,20,1807,388,2195
09/09/2018,#####,21,1786,329,2115
09/09/2018,#####,22,1721,354,2075
09/09/2018,#####,23,1855,412,2267
10/09/2018,#####,0,1979,484,2463
10/09/2018,#####,1,2094,552,2646
10/09/2018,#####,2,2218,586,2804
10/09/2018,#####,3,2060,511,2571
10/09/2018,#####,4,1795,512,2307
10/09/2018,#####,5,1770,559,2329
10/09/2018,#####,6,1868,741,2609
10/09/2018,#####,7,2019,913,2932
10/09/2018,#####,8,2278,727,3005
10/09/2018,#####,9,2347,610,2957
10/09/2018,#####,10,2698,667,3365
10/09/2018,#####,11,3031,654,3685
10/09/2018,#####,12,3049,631,3680
10/09/2018,#####,13,3013,557,3570
10/09/2018,#####,14,3034,535,3569
10/09/2018,#####,15,2858,501,3359
10/09/2018,#####,16,2777,468,3245
10/09/2018,#####,17,2752,494,3246
10/09/2018,#####,18,2577,537,3114
10/09/2018,#####,19,2379,470,2849
10/09/2018,#####,20,2239,474,2713
10/09/2018,#####,21,2069,407,2476
10/09/2018,#####,22,1949,386,2335
10/09/2018,#####,23,1707,391,2098
11/09/2018,#####,0,1617,504,2121
11/09/2018,#####,1,1666,445,2111
11/09/2018,#####,2,1545,390,1935
11/09/2018,#####,3,1550,395,1945
11/09/2018,#####,4,1547,426,1973
11/09/2018,#####,5,1623,473,2096
11/09/2018,#####,6,2160,611,2771
11/09/2018,#####,7,2441,796,3237
11/09/2018,#####,8,2597,764,3361
11/09/2018,#####,9,2932,711,3643
11/09/2018,#####,10,3018,797,3815
11/09/2018,#####,11,3227,971,4198
11/09/2018,#####,12,4032,1166,5198
11/09/2018,#####,13,3142,1019,4161
11/09/2018,#####,14,3400,1095,4495
11/09/2018,#####,15,3478,1181,4659
11/09/2018,#####,16,3246,1148,4394
11/09/2018,#####,17,2899,1179,4078
11/09/2018,#####,18,2703,1163,3866
11/09/2018,#####,19,2323,1092,3415
11/09/2018,#####,20,2433,1033,3466
11/09/2018,#####,21,2512,964,3476
11/09/2018,#####,22,2274,812,3086
11/09/2018,#####,23,2187,751,2938
12/09/2018,#####,0,2479,712,3191
12/09/2018,#####,1,2556,820,3376
12/09/2018,#####,2,2344,799,3143
12/09/2018,#####,3,2487,781,3268
12/09/2018,#####,4,2537,735,3272
12/09/2018,#####,5,2661,608,3269
12/09/2018,#####,6,3044,633,3677
12/09/2018,#####,7,3063,678,3741
12/09/2018,#####,8,2989,655,3644
12/09/2018,#####,9,2915,729,3644
12/09/2018,#####,10,2956,818,3774
12/09/2018,#####,11,3068,1021,4089
12/09/2018,#####,12,3497,946,4443
12/09/2018,#####,13,3694,879,4573
12/09/2018,#####,14,3789,941,4730
12/09/2018,#####,15,3668,903,4571
12/09/2018,#####,16,3609,885,4494
12/09/2018,#####,17,3596,823,4419
12/09/2018,#####,18,3144,743,3887
12/09/2018,#####,19,2702,701,3403
12/09/2018,#####,20,2731,654,3385
12/09/2018,#####,21,2637,616,3253
12/09/2018,#####,22,2376,548,2924
12/09/2018,#####,23,2017,515,2532
13/09/2018,#####,0,1963,484,2447
13/09/2018,#####,1,1815,447,2262
13/09/2018,#####,2,1693,409,2102
13/09/2018,#####,3,1628,390,2018
13/09/2018,#####,4,1502,367,1869
13/09/2018,#####,5,1630,359,1989
13/09/2018,#####,6,1712,369,2081
13/09/2018,#####,7,1814,458,2272
13/09/2018,#####,8,1952,541,2493
13/09/2018,#####,9,1978,601,2579
13/09/2018,#####,10,2274,641,2915
13/09/2018,#####,11,2217,646,2863
13/09/2018,#####,12,2445,667,3112
13/09/2018,#####,13,2554,656,3210
13/09/2018,#####,14,2870,620,3490
13/09/2018,#####,15,2869,578,3447
13/09/2018,#####,16,2826,527,3353
13/09/2018,#####,17,2875,477,3352
13/09/2018,#####,18,2572,410,2982
13/09/2018,#####,19,2510,402,2912
13/09/2018,#####,20,2521,419,2940
13/09/2018,#####,21,2411,427,2838
13/09/2018,#####,22,2074,414,2488
13/09/2018,#####,23,2177,394,2571
14/09/2018,#####,0,2155,402,2557
14/09/2018,#####,1,2359,425,2784
14/09/2018,#####,2,2310,453,2763
14/09/2018,#####,3,2266,465,2731
14/09/2018,#####,4,2203,469,2672
14/09/2018,#####,5,2293,490,2783
14/09/2018,#####,6,2622,529,3151
14/09/2018,#####,7,2624,596,3220
14/09/2018,#####,8,2669,659,3328
14/09/2018,#####,9,2653,656,3309
14/09/2018,#####,10,2749,668,3417
14/09/2018,#####,11,2519,686,3205
14/09/2018,#####,12,2548,654,3202
14/09/2018,#####,13,2481,637,3118
14/09/2018,#####,14,2470,711,3181
14/09/2018,#####,15,2386,666,3052
14/09/2018,#####,16,2577,569,3146
14/09/2018,#####,17,2703,491,3194
14/09/2018,#####,18,2842,467,3309
14/09/2018,#####,19,2698,521,3219
14/09/2018,#####,20,2561,504,3065
14/09/2018,#####,21,2535,506,3041
14/09/2018,#####,22,2392,495,2887
14/09/2018,#####,23,2185,493,2678
15/09/2018,#####,0,1961,498,2459
15/09/2018,#####,1,1954,519,2473
15/09/2018,#####,2,1859,609,2468
15/09/2018,#####,3,1617,767,2384
15/09/2018,#####,4,1506,772,2278
15/09/2018,#####,5,1467,796,2263
15/09/2018,#####,6,1509,813,2322
15/09/2018,#####,7,1727,849,2576
15/09/2018,#####,8,1781,883,2664
15/09/2018,#####,9,1992,947,2939
15/09/2018,#####,10,2259,965,3224
15/09/2018,#####,11,2566,1045,3611
15/09/2018,#####,12,2342,1051,3393
15/09/2018,#####,13,2107,987,3094
15/09/2018,#####,14,2109,939,3048
15/09/2018,#####,15,2157,735,2892
15/09/2018,#####,16,2320,683,3003
15/09/2018,#####,17,2314,623,2937
15/09/2018,#####,18,2121,577,2698
15/09/2018,#####,19,1760,550,2310
15/09/2018,#####,20,1739,634,2373
15/09/2018,#####,21,1550,597,2147
15/09/2018,#####,22,1395,560,1955
15/09/2018,#####,23,1245,500,1745
16/09/2018,#####,0,1148,463,1611
16/09/2018,#####,1,1156,475,1631
16/09/2018,#####,2,1076,446,1522
16/09/2018,#####,3,859,403,1262
16/09/2018,#####,4,845,382,1227
16/09/2018,#####,5,857,373,1230
16/09/2018,#####,6,909,358,1267
16/09/2018,#####,7,1109,382,1491
16/09/2018,#####,8,1418,464,1882
16/09/2018,#####,9,1573,548,2121
16/09/2018,#####,10,1707,625,2332
16/09/2018,#####,11,2138,671,2809
16/09/2018,#####,12,2583,665,3248
16/09/2018,#####,13,2967,715,3682
16/09/2018,#####,14,3153,789,3942
16/09/2018,#####,15,3307,757,4064
16/09/2018,#####,16,3447,736,4183
16/09/2018,#####,17,3676,662,4338
16/09/2018,#####,18,3631,643,4274
16/09/2018,#####,19,2955,613,3568
16/09/2018,#####,20,3200,617,3817
16/09/2018,#####,21,3179,626,3805
16/09/2018,#####,22,3037,703,3740
16/09/2018,#####,23,2707,742,3449
17/09/2018,#####,0,2406,770,3176
17/09/2018,#####,1,2474,758,3232
17/09/2018,#####,2,2228,776,3004
17/09/2018,#####,3,2063,771,2834
17/09/2018,#####,4,1730,659,2389
17/09/2018,#####,5,1729,592,2321
17/09/2018,#####,6,1623,602,2225
17/09/2018,#####,7,1699,699,2398
17/09/2018,#####,8,1690,719,2409
17/09/2018,#####,9,1655,659,2314
17/09/2018,#####,10,1608,620,2228
17/09/2018,#####,11,1666,606,2272
17/09/2018,#####,12,1633,603,2236
17/09/2018,#####,13,1580,591,2171
17/09/2018,#####,14,1544,545,2089
17/09/2018,#####,15,1730,525,2255
17/09/2018,#####,16,1733,451,2184
17/09/2018,#####,17,1828,445,2273
17/09/2018,#####,18,1906,418,2324
17/09/2018,#####,19,1870,388,2258
17/09/2018,#####,20,2001,372,2373
17/09/2018,#####,21,1958,364,2322
17/09/2018,#####,22,1856,303,2159
17/09/2018,#####,23,1771,269,2040
18/09/2018,#####,0,1835,302,2137
18/09/2018,#####,1,1891,359,2250
18/09/2018,#####,2,1832,385,2217
18/09/2018,#####,3,1769,434,2203
18/09/2018,#####,4,1682,456,2138
18/09/2018,#####,5,1797,489,2286
18/09/2018,#####,6,2054,540,2594
18/09/2018,#####,7,2422,594,3016
18/09/2018,#####,8,2498,626,3124
18/09/2018,#####,9,2405,690,3095
18/09/2018,#####,10,2445,746,3191
18/09/2018,#####,11,2343,825,3168
18/09/2018,#####,12,2102,920,3022
18/09/2018,#####,13,2267,966,3233
18/09/2018,#####,14,2616,997,3613
18/09/2018,#####,15,2839,987,3826
18/09/2018,#####,16,3305,970,4275
18/09/2018,#####,17,3363,868,4231
18/09/2018,#####,18,3366,824,4190
18/09/2018,#####,19,3295,819,4114
18/09/2018,#####,20,3106,820,3926
18/09/2018,#####,21,2944,608,3552
18/09/2018,#####,22,2932,454,3386
18/09/2018,#####,23,2641,457,3098
19/09/2018,#####,0,2489,438,2927
19/09/2018,#####,1,2461,429,2890
19/09/2018,#####,2,2292,469,2761
19/09/2018,#####,3,2157,498,2655
19/09/2018,#####,4,2007,483,2490
19/09/2018,#####,5,2097,486,2583
19/09/2018,#####,6,2210,500,2710
19/09/2018,#####,7,2190,588,2778
19/09/2018,#####,8,2316,612,2928
19/09/2018,#####,9,2629,775,3404
19/09/2018,#####,10,2813,736,3549
19/09/2018,#####,11,2879,756,3635
19/09/2018,#####,12,2436,691,3127
19/09/2018,#####,13,2761,794,3555
19/09/2018,#####,14,2690,829,3519
19/09/2018,#####,15,3162,806,3968
19/09/2018,#####,16,3107,733,3840
19/09/2018,#####,17,3096,618,3714
19/09/2018,#####,18,3433,570,4003
19/09/2018,#####,19,3667,632,4299
19/09/2018,#####,20,3713,675,4388
19/09/2018,#####,21,3775,562,4337
19/09/2018,#####,22,3704,528,4232
19/09/2018,#####,23,3596,614,4210
20/09/2018,#####,0,3333,733,4066
20/09/2018,#####,1,2945,798,3743
20/09/2018,#####,2,2679,791,3470
20/09/2018,#####,3,2402,718,3120
20/09/2018,#####,4,2218,673,2891
20/09/2018,#####,5,2011,616,2627
20/09/2018,#####,6,2095,610,2705
20/09/2018,#####,7,2267,656,2923
20/09/2018,#####,8,2320,679,2999
20/09/2018,#####,9,2325,807,3132
20/09/2018,#####,10,2150,828,2978
20/09/2018,#####,11,2290,875,3165
20/09/2018,#####,12,2431,817,3248
20/09/2018,#####,13,2259,822,3081
20/09/2018,#####,14,2013,852,2865
20/09/2018,#####,15,1737,701,2438
20/09/2018,#####,16,1388,525,1913
20/09/2018,#####,17,1482,626,2108
20/09/2018,#####,18,1306,750,2056
20/09/2018,#####,19,1126,794,1920
20/09/2018,#####,20,1212,615,1827
20/09/2018,#####,21,1485,481,1966
20/09/2018,#####,22,1785,387,2172
20/09/2018,#####,23,2250,418,2668
21/09/2018,#####,0,2740,569,3309
21/09/2018,#####,1,2860,687,3547
21/09/2018,#####,2,2581,719,3300
21/09/2018,#####,3,2704,771,3475
21/09/2018,#####,4,2995,880,3875
21/09/2018,#####,5,2694,958,3652
21/09/2018,#####,6,2702,1002,3704
21/09/2018,#####,7,2738,1070,3808
21/09/2018,#####,8,2790,1100,3890
21/09/2018,#####,9,3436,1189,4625
21/09/2018,#####,10,3792,1332,5124
21/09/2018,#####,11,3543,1370,4913
21/09/2018,#####,12,3396,1324,4720
21/09/2018,#####,13,3288,1313,4601
21/09/2018,#####,14,3590,1269,4859
21/09/2018,#####,15,3481,1186,4667
21/09/2018,#####,16,3461,1173,4634
21/09/2018,#####,17,3637,1233,4870
21/09/2018,#####,18,3254,1265,4519
21/09/2018,#####,19,3412,1236,4648
21/09/2018,#####,20,3398,1252,4650
21/09/2018,#####,21,3138,1202,4340
21/09/2018,#####,22,3039,1182,4221
21/09/2018,#####,23,2995,1162,4157
22/09/2018,#####,0,2883,1038,3921
22/09/2018,#####,1,2848,1140,3988
22/09/2018,#####,2,2946,1158,4104
22/09/2018,#####,3,2932,1168,4100
22/09/2018,#####,4,3256,1152,4408
22/09/2018,#####,5,3304,1111,4415
22/09/2018,#####,6,2968,1066,4034
22/09/2018,#####,7,2520,1006,3526
22/09/2018,#####,8,2885,1080,3965
22/09/2018,#####,9,3073,1202,4275
22/09/2018,#####,10,3382,1319,4701
22/09/2018,#####,11,3387,1368,4755
22/09/2018,#####,12,3216,1353,4569
22/09/2018,#####,13,2750,1416,4166
22/09/2018,#####,14,2658,1431,4089
22/09/2018,#####,15,2703,1392,4095
22/09/2018,#####,16,3333,1323,4656
22/09/2018,#####,17,3630,1246,4876
22/09/2018,#####,18,3169,1156,4325
22/09/2018,#####,19,3478,1070,4548
22/09/2018,#####,20,3191,1107,4298
22/09/2018,#####,21,2993,1111,4104
22/09/2018,#####,22,3005,1119,4124
22/09/2018,#####,23,2986,1123,4109
23/09/2018,#####,0,2690,1078,3768
23/09/2018,#####,1,2844,1012,3856
23/09/2018,#####,2,2753,993,3746
23/09/2018,#####,3,2876,961,3837
23/09/2018,#####,4,2747,922,3669
23/09/2018,#####,5,2654,883,3537
23/09/2018,#####,6,2594,874,3468
23/09/2018,#####,7,2552,861,3413
23/09/2018,#####,8,2526,806,3332
23/09/2018,#####,9,2572,866,3438
23/09/2018,#####,10,2800,815,3615
23/09/2018,#####,11,2923,851,3774
23/09/2018,#####,12,2936,830,3766
23/09/2018,#####,13,3012,759,3771
23/09/2018,#####,14,3072,672,3744
23/09/2018,#####,15,3149,608,3757
23/09/2018,#####,16,3337,573,3910
23/09/2018,#####,17,3320,591,3911
23/09/2018,#####,18,3026,612,3638
23/09/2018,#####,19,2661,684,3345
23/09/2018,#####,20,2462,784,3246
23/09/2018,#####,21,2699,954,3653
23/09/2018,#####,22,2781,1030,3811
23/09/2018,#####,23,2814,1108,3922
24/09/2018,#####,0,2493,1019,3512
24/09/2018,#####,1,2603,1102,3705
24/09/2018,#####,2,2887,1144,4031
24/09/2018,#####,3,2884,1153,4037
24/09/2018,#####,4,2659,1142,3801
24/09/2018,#####,5,2456,1159,3615
24/09/2018,#####,6,2289,1175,3464
24/09/2018,#####,7,2445,1186,3631
24/09/2018,#####,8,2310,1212,3522
24/09/2018,#####,9,3103,1276,4379
24/09/2018,#####,10,3258,1328,4586
24/09/2018,#####,11,2932,1351,4283
24/09/2018,#####,12,2931,1345,4276
24/09/2018,#####,13,3153,1343,4496
24/09/2018,#####,14,3389,1289,4678
24/09/2018,#####,15,3526,1187,4713
24/09/2018,#####,16,3587,1350,4937
24/09/2018,#####,17,3220,1264,4484
24/09/2018,#####,18,2790,1188,3978
24/09/2018,#####,19,2718,1179,3897
24/09/2018,#####,20,2836,1158,3994
24/09/2018,#####,21,2789,1160,3949
24/09/2018,#####,22,2664,1062,3726
24/09/2018,#####,23,2514,993,3507
25/09/2018,#####,0,2275,1075,3350
25/09/2018,#####,1,2204,1026,3230
25/09/2018,#####,2,1995,956,2951
25/09/2018,#####,3,1828,931,2759
25/09/2018,#####,4,1775,898,2673
25/09/2018,#####,5,1613,901,2514
25/09/2018,#####,6,1661,890,2551
25/09/2018,#####,7,1843,864,2707
25/09/2018,#####,8,1842,804,2646
25/09/2018,#####,9,1902,859,2761
25/09/2018,#####,10,1996,953,2949
25/09/2018,#####,11,2119,1044,3163
25/09/2018,#####,12,2254,1009,3263
25/09/2018,#####,13,2337,890,3227
25/09/2018,#####,14,2458,719,3177
25/09/2018,#####,15,2539,740,3279
25/09/2018,#####,16,2560,657,3217
25/09/2018,#####,17,2789,587,3376
25/09/2018,#####,18,2655,640,3295
25/09/2018,#####,19,2635,876,3511
25/09/2018,#####,20,2626,949,3575
25/09/2018,#####,21,2663,947,3610
25/09/2018,#####,22,2812,953,3765
25/09/2018,#####,23,2859,1042,3901
26/09/2018,#####,0,3218,1124,4342
26/09/2018,#####,1,3330,1170,4500
26/09/2018,#####,2,3462,1242,4704
26/09/2018,#####,3,3327,1294,4621
26/09/2018,#####,4,3488,1328,4816
26/09/2018,#####,5,3485,1349,4834
26/09/2018,#####,6,3746,1378,5124
26/09/2018,#####,7,3249,1420,4669
26/09/2018,#####,8,3271,1431,4702
26/09/2018,#####,9,3525,1383,4908
26/09/2018,#####,10,3695,1406,5101
26/09/2018,#####,11,3808,1409,5217
26/09/2018,#####,12,3948,1402,5350
26/09/2018,#####,13,3696,1367,5063
26/09/2018,#####,14,3562,1334,4896
26/09/2018,#####,15,3572,1323,4895
26/09/2018,#####,16,3685,1304,4989
26/09/2018,#####,17,3640,1265,4905
26/09/2018,#####,18,3126,1236,4362
26/09/2018,#####,19,2856,1216,4072
26/09/2018,#####,20,2616,1176,3792
26/09/2018,#####,21,2483,1133,3616
26/09/2018,#####,22,2217,1112,3329
26/09/2018,#####,23,2136,1093,3229
27/09/2018,#####,0,2136,977,3113
27/09/2018,#####,1,1892,946,2838
27/09/2018,#####,2,1848,905,2753
27/09/2018,#####,3,1918,970,2888
27/09/2018,#####,4,2028,929,2957
27/09/2018,#####,5,1823,901,2724
27/09/2018,#####,6,1847,820,2667
27/09/2018,#####,7,2224,873,3097
27/09/2018,#####,8,3015,956,3971
27/09/2018,#####,9,3584,1006,4590
27/09/2018,#####,10,3965,974,4939
27/09/2018,#####,11,3950,1052,5002
27/09/2018,#####,12,4123,1219,5342
27/09/2018,#####,13,4325,1246,5571
27/09/2018,#####,14,4337,1204,5541
27/09/2018,#####,15,4271,1254,5525
27/09/2018,#####,16,4392,1258,5650
27/09/2018,#####,17,4093,1211,5304
27/09/2018,#####,18,3779,1185,4964
27/09/2018,#####,19,3580,1195,4775
27/09/2018,#####,20,3546,1195,4741
27/09/2018,#####,21,3447,1199,4646
27/09/2018,#####,22,3231,1180,4411
27/09/2018,#####,23,3075,1142,4217
28/09/2018,#####,0,2996,1113,4109
28/09/2018,#####,1,3030,1132,4162
28/09/2018,#####,2,3286,1142,4428
28/09/2018,#####,3,3295,1130,4425
28/09/2018,#####,4,3250,1092,4342
28/09/2018,#####,5,3168,1109,4277
28/09/2018,#####,6,3159,1126,4285
28/09/2018,#####,7,3155,1144,4299
28/09/2018,#####,8,3097,1247,4344
28/09/2018,#####,9,3269,1322,4591
28/09/2018,#####,10,3635,1360,4995
28/09/2018,#####,11,3530,1304,4834
28/09/2018,#####,12,3552,1164,4716
28/09/2018,#####,13,3032,1185,4217
28/09/2018,#####,14,3164,1168,4332
28/09/2018,#####,15,3224,1148,4372
28/09/2018,#####,16,3289,1070,4359
28/09/2018,#####,17,3281,1030,4311
28/09/2018,#####,18,3302,1051,4353
28/09/2018,#####,19,2976,1099,4075
28/09/2018,#####,20,2563,1017,3580
28/09/2018,#####,21,2356,997,3353
28/09/2018,#####,22,2124,981,3105
28/09/2018,#####,23,1886,981,2867
29/09/2018,#####,0,1756,886,2642
29/09/2018,#####,1,1601,797,2398
29/09/2018,#####,2,1457,704,2161
29/09/2018,#####,3,1307,651,1958
29/09/2018,#####,4,1277,594,1871
29/09/2018,#####,5,1322,557,1879
29/09/2018,#####,6,1468,423,1891
29/09/2018,#####,7,1510,469,1979
29/09/2018,#####,8,1561,500,2061
29/09/2018,#####,9,1785,530,2315
29/09/2018,#####,10,2134,669,2803
29/09/2018,#####,11,2497,783,3280
29/09/2018,#####,12,3002,744,3746
29/09/2018,#####,13,3388,807,4195
29/09/2018,#####,14,3402,878,4280
29/09/2018,#####,15,3505,883,4388
29/09/2018,#####,16,3442,865,4307
29/09/2018,#####,17,3339,807,4146
29/09/2018,#####,18,3295,881,4176
29/09/2018,#####,19,3193,887,4080
29/09/2018,#####,20,3126,908,4034
29/09/2018,#####,21,3056,994,4050
29/09/2018,#####,22,2737,1031,3768
29/09/2018,#####,23,2700,1082,3782
30/09/2018,#####,0,2840,1071,3911
30/09/2018,#####,1,2880,1039,3919
30/09/2018,#####,2,2818,1060,3878
30/09/2018,#####,3,2673,1038,3711
30/09/2018,#####,4,2600,997,3597
30/09/2018,#####,5,2551,977,3528
30/09/2018,#####,6,2325,949,3274
30/09/2018,#####,7,2187,925,3112
30/09/2018,#####,8,2355,931,3286
30/09/2018,#####,9,2326,916,3242
30/09/2018,#####,10,2479,935,3414
30/09/2018,#####,11,2765,964,3729
30/09/2018,#####,12,2729,978,3707
30/09/2018,#####,13,2593,945,3538
30/09/2018,#####,14,2449,870,3319
30/09/2018,#####,15,2159,825,2984
30/09/2018,#####,16,2001,731,2732
30/09/2018,#####,17,2089,680,2769
30/09/2018,#####,18,2011,820,2831
30/09/2018,#####,19,1903,838,2741
30/09/2018,#####,20,1932,789,2721
30/09/2018,#####,21,1930,497,2427
30/09/2018,#####,22,1829,463,2292
30/09/2018,#####,23,1759,456,2215
01/10/2018,#####,0,1418,486,1904
01/10/2018,#####,1,1430,408,1838
01/10/2018,#####,2,1332,374,1706
01/10/2018,#####,3,1387,368,1755
01/10/2018,#####,4,1493,376,1869
01/10/2018,#####,5,1717,418,2135
01/10/2018,#####,6,2097,477,2574
01/10/2018,#####,7,2382,526,2908
01/10/2018,#####,8,2579,565,3144
01/10/2018,#####,9,2558,604,3162
01/10/2018,#####,10,2718,647,3365
01/10/2018,#####,11,2833,729,3562
01/10/2018,#####,12,3138,790,3928
01/10/2018,#####,13,3208,836,4044
01/10/2018,#####,14,3027,803,3830
01/10/2018,#####,15,2860,836,3696
01/10/2018,#####,16,2793,952,3745
01/10/2018,#####,17,2906,967,3873
01/10/2018,#####,18,2869,980,3849
01/10/2018,#####,19,2999,1062,4061
01/10/2018,#####,20,2988,1053,4041
01/10/2018,#####,21,2530,1006,3536
01/10/2018,#####,22,2209,1029,3238
01/10/2018,#####,23,1846,1014,2860
02/10/2018,#####,0,2099,982,3081
02/10/2018,#####,1,2264,870,3134
02/10/2018,#####,2,2178,993,3171
02/10/2018,#####,3,2066,858,2924
02/10/2018,#####,4,2052,826,2878
02/10/2018,#####,5,2216,803,3019
02/10/2018,#####,6,2209,882,3091
02/10/2018,#####,7,2345,1026,3371
02/10/2018,#####,8,2746,1068,3814
02/10/2018,#####,9,3229,1168,4397
02/10/2018,#####,10,3565,1269,4834
02/10/2018,#####,11,3337,1368,4705
02/10/2018,#####,12,3190,1393,4583
02/10/2018,#####,13,3699,1373,5072
02/10/2018,#####,14,3572,1419,4991
02/10/2018,#####,15,3467,1478,4945
02/10/2018,#####,16,3309,1517,4826
02/10/2018,#####,17,3496,1461,4957
02/10/2018,#####,18,3409,1288,4697
02/10/2018,#####,19,3510,1315,4825
02/10/2018,#####,20,3959,1442,5401
02/10/2018,#####,21,3958,1451,5409
02/10/2018,#####,22,3127,1414,4541
02/10/2018,#####,23,2717,1424,4141
03/10/2018,#####,0,2698,1413,4111
03/10/2018,#####,1,2652,1396,4048
03/10/2018,#####,2,2450,1387,3837
03/10/2018,#####,3,2296,1356,3652
03/10/2018,#####,4,2120,1318,3438
03/10/2018,#####,5,2054,1298,3352
03/10/2018,#####,6,1987,1401,3388
03/10/2018,#####,7,2309,1398,3707
03/10/2018,#####,8,2547,1356,3903
03/10/2018,#####,9,2472,1452,3924
03/10/2018,#####,10,2603,1567,4170
03/10/2018,#####,11,2598,1666,4264
03/10/2018,#####,12,2455,1655,4110
03/10/2018,#####,13,2494,1643,4137
03/10/2018,#####,14,2438,1598,4036
03/10/2018,#####,15,2420,1514,3934
03/10/2018,#####,16,2438,1395,3833
03/10/2018,#####,17,2666,1350,4016
03/10/2018,#####,18,2711,1244,3955
03/10/2018,#####,19,3011,1336,4347
03/10/2018,#####,20,2862,1367,4229
03/10/2018,#####,21,2606,1209,3815
03/10/2018,#####,22,2321,1090,3411
03/10/2018,#####,23,2042,909,2951
04/10/2018,#####,0,1912,914,2826
04/10/2018,#####,1,1507,829,2336
04/10/2018,#####,2,1291,743,2034
04/10/2018,#####,3,1192,707,1899
04/10/2018,#####,4,1144,690,1834
04/10/2018,#####,5,1305,666,1971
04/10/2018,#####,6,1541,803,2344
04/10/2018,#####,7,1740,884,2624
04/10/2018,#####,8,1743,583,2326
04/10/2018,#####,9,1867,549,2416
04/10/2018,#####,10,2111,677,2788
04/10/2018,#####,11,2328,758,3086
04/10/2018,#####,12,2312,772,3084
04/10/2018,#####,13,2687,878,3565
04/10/2018,#####,14,2916,1074,3990
04/10/2018,#####,15,3046,1051,4097
04/10/2018,#####,16,3081,1026,4107
04/10/2018,#####,17,3014,1096,4110
04/10/2018,#####,18,2951,1140,4091
04/10/2018,#####,19,2953,1092,4045
04/10/2018,#####,20,3052,1087,4139
04/10/2018,#####,21,3149,1189,4338
04/10/2018,#####,22,3054,1072,4126
04/10/2018,#####,23,2903,953,3856
05/10/2018,#####,0,2853,890,3743
05/10/2018,#####,1,2406,788,3194
05/10/2018,#####,2,2338,725,3063
05/10/2018,#####,3,2434,752,3186
05/10/2018,#####,4,2236,865,3101
05/10/2018,#####,5,1888,868,2756
05/10/2018,#####,6,1918,981,2899
05/10/2018,#####,7,2152,1001,3153
05/10/2018,#####,8,2119,1227,3346
05/10/2018,#####,9,2101,1243,3344
05/10/2018,#####,10,2152,1113,3265
05/10/2018,#####,11,2124,953,3077
05/10/2018,#####,12,2064,949,3013
05/10/2018,#####,13,2421,921,3342
05/10/2018,#####,14,2241,892,3133
05/10/2018,#####,15,2263,992,3255
05/10/2018,#####,16,2267,997,3264
05/10/2018,#####,17,2215,1019,3234
05/10/2018,#####,18,2102,1026,3128
05/10/2018,#####,19,2011,1002,3013
05/10/2018,#####,20,1916,930,2846
05/10/2018,#####,21,1829,944,2773
05/10/2018,#####,22,1634,953,2587
05/10/2018,#####,23,1506,818,2324
06/10/2018,#####,0,1301,704,2005
06/10/2018,#####,1,1065,613,1678
06/10/2018,#####,2,852,558,1410
06/10/2018,#####,3,859,486,1345
06/10/2018,#####,4,892,444,1336
06/10/2018,#####,5,867,484,1351
06/10/2018,#####,6,1138,478,1616
06/10/2018,#####,7,1308,502,1810
06/10/2018,#####,8,1301,642,1943
06/10/2018,#####,9,1177,752,1929
06/10/2018,#####,10,1246,759,2005
06/10/2018,#####,11,1337,724,2061
06/10/2018,#####,12,1469,696,2165
06/10/2018,#####,13,1507,625,2132
06/10/2018,#####,14,1479,533,2012
06/10/2018,#####,15,1590,577,2167
06/10/2018,#####,16,1735,666,2401
06/10/2018,#####,17,2017,654,2671
06/10/2018,#####,18,2116,742,2858
06/10/2018,#####,19,2208,735,2943
06/10/2018,#####,20,2153,668,2821
06/10/2018,#####,21,1963,552,2515
06/10/2018,#####,22,1743,556,2299
06/10/2018,#####,23,1369,521,1890
07/10/2018,#####,0,1555,596,2151
07/10/2018,#####,1,1505,735,2240
07/10/2018,#####,2,1489,991,2480
07/10/2018,#####,3,1410,1145,2555
07/10/2018,#####,4,1555,1159,2714
07/10/2018,#####,5,1595,1081,2676
07/10/2018,#####,6,1652,994,2646
07/10/2018,#####,7,1728,917,2645
07/10/2018,#####,8,1600,855,2455
07/10/2018,#####,9,1659,846,2505
07/10/2018,#####,10,1681,838,2519
07/10/2018,#####,11,1712,845,2557
07/10/2018,#####,12,1564,796,2360
07/10/2018,#####,13,1440,735,2175
07/10/2018,#####,14,1364,691,2055
07/10/2018,#####,15,1362,649,2011
07/10/2018,#####,16,1399,589,1988
07/10/2018,#####,17,1361,581,1942
07/10/2018,#####,18,1528,693,2221
07/10/2018,#####,19,1624,715,2339
07/10/2018,#####,20,1769,717,2486
07/10/2018,#####,21,1735,667,2402
07/10/2018,#####,22,2059,552,2611
07/10/2018,#####,23,2127,588,2715
08/10/2018,#####,0,2165,620,2785
08/10/2018,#####,1,2357,689,3046
08/10/2018,#####,2,2714,733,3447
08/10/2018,#####,3,2991,771,3762
08/10/2018,#####,4,2840,826,3666
08/10/2018,#####,5,2876,909,3785
08/10/2018,#####,6,2844,1016,3860
08/10/2018,#####,7,3076,1078,4154
08/10/2018,#####,8,3220,1123,4343
08/10/2018,#####,9,3362,1198,4560
08/10/2018,#####,10,3532,1223,4755
08/10/2018,#####,11,3586,1355,4941
08/10/2018,#####,12,3677,1425,5102
08/10/2018,#####,13,3583,1254,4837
08/10/2018,#####,14,3493,1204,4697
08/10/2018,#####,15,3230,1121,4351
08/10/2018,#####,16,3173,1092,4265
08/10/2018,#####,17,3025,1155,4180
08/10/2018,#####,18,2776,1189,3965
08/10/2018,#####,19,2720,1271,3991
08/10/2018,#####,20,2736,1092,3828
08/10/2018,#####,21,2715,913,3628
08/10/2018,#####,22,2748,852,3600
08/10/2018,#####,23,3074,807,3881
09/10/2018,#####,0,2270,807,3077
09/10/2018,#####,1,2231,805,3036
09/10/2018,#####,2,1929,776,2705
09/10/2018,#####,3,1851,783,2634
09/10/2018,#####,4,1711,754,2465
09/10/2018,#####,5,1896,732,2628
09/10/2018,#####,6,1988,838,2826
09/10/2018,#####,7,2249,1159,3408
09/10/2018,#####,8,2399,1247,3646
09/10/2018,#####,9,2650,1327,3977
09/10/2018,#####,10,2738,1433,4171
09/10/2018,#####,11,3112,1352,4464
09/10/2018,#####,12,3373,1491,4864
09/10/2018,#####,13,3384,1344,4728
09/10/2018,#####,14,3388,1274,4662
09/10/2018,#####,15,3349,1189,4538
09/10/2018,#####,16,3112,1087,4199
09/10/2018,#####,17,3525,1121,4646
09/10/2018,#####,18,3349,1035,4384
09/10/2018,#####,19,2981,1056,4037
09/10/2018,#####,20,2658,980,3638
09/10/2018,#####,21,2570,1027,3597
09/10/2018,#####,22,2572,808,3380
09/10/2018,#####,23,2256,719,2975
10/10/2018,#####,0,2218,700,2918
10/10/2018,#####,1,2049,609,2658
10/10/2018,#####,2,1752,599,2351
10/10/2018,#####,3,1548,583,2131
10/10/2018,#####,4,1453,594,2047
10/10/2018,#####,5,1608,627,2235
10/10/2018,#####,6,1829,711,2540
10/10/2018,#####,7,1866,792,2658
10/10/2018,#####,8,1646,837,2483
10/10/2018,#####,9,1695,810,2505
10/10/2018,#####,10,1894,675,2569
10/10/2018,#####,11,1761,706,2467
10/10/2018,#####,12,1530,719,2249
10/10/2018,#####,13,1469,736,2205
10/10/2018,#####,14,1471,727,2198
10/10/2018,#####,15,1568,702,2270
10/10/2018,#####,16,1480,658,2138
10/10/2018,#####,17,1638,695,2333
10/10/2018,#####,18,1530,789,2319
10/10/2018,#####,19,1770,931,2701
10/10/2018,#####,20,1687,984,2671
10/10/2018,#####,21,1830,934,2764
10/10/2018,#####,22,1751,941,2692
10/10/2018,#####,23,1958,1013,2971
11/10/2018,#####,0,2220,1002,3222
11/10/2018,#####,1,2246,1017,3263
11/10/2018,#####,2,2382,1046,3428
11/10/2018,#####,3,2366,1061,3427
11/10/2018,#####,4,1965,1027,2992
11/10/2018,#####,5,2084,1020,3104
11/10/2018,#####,6,2200,1012,3212
11/10/2018,#####,7,2504,1295,3799
11/10/2018,#####,8,2089,1231,3320
11/10/2018,#####,9,2061,1044,3105
11/10/2018,#####,10,2361,1029,3390
11/10/2018,#####,11,2565,1068,3633
11/10/2018,#####,12,2479,1150,3629
11/10/2018,#####,13,2426,1080,3506
11/10/2018,#####,14,2426,1084,3510
11/10/2018,#####,15,2701,1148,3849
11/10/2018,#####,16,2428,1112,3540
11/10/2018,#####,17,2461,991,3452
11/10/2018,#####,18,2555,1090,3645
11/10/2018,#####,19,2443,1018,3461
11/10/2018,#####,20,2275,980,3255
11/10/2018,#####,21,2233,941,3174
11/10/2018,#####,22,2181,979,3160
11/10/2018,#####,23,1606,1004,2610
12/10/2018,#####,0,2039,972,3011
12/10/2018,#####,1,2073,957,3030
12/10/2018,#####,2,1938,928,2866
12/10/2018,#####,3,1965,872,2837
12/10/2018,#####,4,1611,846,2457
12/10/2018,#####,5,1686,831,2517
12/10/2018,#####,6,2083,951,3034
12/10/2018,#####,7,1737,891,2628
12/10/2018,#####,8,1685,811,2496
12/10/2018,#####,9,1775,824,2599
12/10/2018,#####,10,2124,851,2975
12/10/2018,#####,11,2308,816,3124
12/10/2018,#####,12,2424,819,3243
12/10/2018,#####,13,2380,768,3148
12/10/2018,#####,14,2353,706,3059
12/10/2018,#####,15,2338,642,2980
12/10/2018,#####,16,2120,610,2730
12/10/2018,#####,17,2548,691,3239
12/10/2018,#####,18,2535,704,3239
12/10/2018,#####,19,2741,681,3422
12/10/2018,#####,20,2698,651,3349
12/10/2018,#####,21,2621,713,3334
12/10/2018,#####,22,2780,769,3549
12/10/2018,#####,23,2736,847,3583
13/10/2018,#####,0,2216,815,3031
13/10/2018,#####,1,2138,828,2966
13/10/2018,#####,2,2235,814,3049
13/10/2018,#####,3,2411,840,3251
13/10/2018,#####,4,2567,856,3423
13/10/2018,#####,5,2637,765,3402
13/10/2018,#####,6,2646,774,3420
13/10/2018,#####,7,2702,752,3454
13/10/2018,#####,8,2696,770,3466
13/10/2018,#####,9,2668,816,3484
13/10/2018,#####,10,2646,916,3562
13/10/2018,#####,11,2707,1050,3757
13/10/2018,#####,12,2813,928,3741
13/10/2018,#####,13,2833,837,3670
13/10/2018,#####,14,2817,811,3628
13/10/2018,#####,15,2786,802,3588
13/10/2018,#####,16,2633,799,3432
13/10/2018,#####,17,2335,783,3118
13/10/2018,#####,18,2434,901,3335
13/10/2018,#####,19,2446,954,3400
13/10/2018,#####,20,2289,999,3288
13/10/2018,#####,21,2304,1070,3374
13/10/2018,#####,22,1876,940,2816
13/10/2018,#####,23,1697,919,2616
14/10/2018,#####,0,1779,925,2704
14/10/2018,#####,1,1862,920,2782
14/10/2018,#####,2,1892,859,2751
14/10/2018,#####,3,1822,750,2572
14/10/2018,#####,4,1743,702,2445
14/10/2018,#####,5,2065,715,2780
14/10/2018,#####,6,2147,878,3025
14/10/2018,#####,7,2105,977,3082
14/10/2018,#####,8,1909,965,2874
14/10/2018,#####,9,1892,957,2849
14/10/2018,#####,10,2126,972,3098
14/10/2018,#####,11,2133,920,3053
14/10/2018,#####,12,2211,901,3112
14/10/2018,#####,13,2217,969,3186
14/10/2018,#####,14,2073,1040,3113
14/10/2018,#####,15,1906,1014,2920
14/10/2018,#####,16,2107,1007,3114
14/10/2018,#####,17,1965,1054,3019
14/10/2018,#####,18,2335,1159,3494
14/10/2018,#####,19,2679,1170,3849
14/10/2018,#####,20,2483,1139,3622
14/10/2018,#####,21,2279,1078,3357
14/10/2018,#####,22,2109,965,3074
14/10/2018,#####,23,1983,849,2832
15/10/2018,#####,0,1516,791,2307
15/10/2018,#####,1,1541,715,2256
15/10/2018,#####,2,1353,655,2008
15/10/2018,#####,3,1168,673,1841
15/10/2018,#####,4,1102,635,1737
15/10/2018,#####,5,1125,696,1821
15/10/2018,#####,6,1602,907,2509
15/10/2018,#####,7,1606,1088,2694
15/10/2018,#####,8,1874,1094,2968
15/10/2018,#####,9,1932,1029,2961
15/10/2018,#####,10,1948,924,2872
15/10/2018,#####,11,1638,821,2459
15/10/2018,#####,12,1615,851,2466
15/10/2018,#####,13,1617,869,2486
15/10/2018,#####,14,1551,813,2364
15/10/2018,#####,15,1730,833,2563
15/10/2018,#####,16,1939,933,2872
15/10/2018,#####,17,2028,873,2901
15/10/2018,#####,18,2109,980,3089
15/10/2018,#####,19,2148,918,3066
15/10/2018,#####,20,1966,896,2862
15/10/2018,#####,21,1656,842,2498
15/10/2018,#####,22,1528,800,2328
15/10/2018,#####,23,1421,836,2257
16/10/2018,#####,0,1379,826,2205
16/10/2018,#####,1,1241,683,1924
16/10/2018,#####,2,1340,635,1975
16/10/2018,#####,3,1247,565,1812
16/10/2018,#####,4,1374,636,2010
16/10/2018,#####,5,1344,765,2109
16/10/2018,#####,6,1516,898,2414
16/10/2018,#####,7,1753,1005,2758
16/10/2018,#####,8,1595,1021,2616
16/10/2018,#####,9,1634,1016,2650
16/10/2018,#####,10,1645,1022,2667
16/10/2018,#####,11,1636,1046,2682
16/10/2018,#####,12,1659,1053,2712
16/10/2018,#####,13,1689,1067,2756
16/10/2018,#####,14,1686,1010,2696
16/10/2018,#####,15,1785,999,2784
16/10/2018,#####,16,1836,950,2786
16/10/2018,#####,17,1859,1008,2867
16/10/2018,#####,18,2053,1078,3131
16/10/2018,#####,19,2062,1074,3136
16/10/2018,#####,20,1876,932,2808
16/10/2018,#####,21,1917,691,2608
16/10/2018,#####,22,1845,574,2419
16/10/2018,#####,23,1809,565,2374
17/10/2018,#####,0,1737,547,2284
17/10/2018,#####,1,1610,533,2143
17/10/2018,#####,2,1549,596,2145
17/10/2018,#####,3,1611,538,2149
17/10/2018,#####,4,1667,543,2210
17/10/2018,#####,5,1795,637,2432
17/10/2018,#####,6,2034,874,2908
17/10/2018,#####,7,2251,915,3166
17/10/2018,#####,8,2362,1007,3369
17/10/2018,#####,9,2450,1073,3523
17/10/2018,#####,10,2376,979,3355
17/10/2018,#####,11,2349,959,3308
17/10/2018,#####,12,2289,856,3145
17/10/2018,#####,13,2276,855,3131
17/10/2018,#####,14,1965,843,2808
17/10/2018,#####,15,1677,960,2637
17/10/2018,#####,16,1509,882,2391
17/10/2018,#####,17,1425,940,2365
17/10/2018,#####,18,1490,979,2469
17/10/2018,#####,19,1464,1021,2485
17/10/2018,#####,20,1338,969,2307
17/10/2018,#####,21,1184,849,2033
17/10/2018,#####,22,1027,676,1703
17/10/2018,#####,23,813,656,1469
18/10/2018,#####,0,984,638,1622
18/10/2018,#####,1,1051,647,1698
18/10/2018,#####,2,1209,709,1918
18/10/2018,#####,3,1236,695,1931
18/10/2018,#####,4,1413,673,2086
18/10/2018,#####,5,1542,662,2204
18/10/2018,#####,6,1857,811,2668
18/10/2018,#####,7,2061,1014,3075
18/10/2018,#####,8,2160,1106,3266
18/10/2018,#####,9,2316,1138,3454
18/10/2018,#####,10,2590,1172,3762
18/10/2018,#####,11,2818,1239,4057
18/10/2018,#####,12,2736,1263,3999
18/10/2018,#####,13,2570,1227,3797
18/10/2018,#####,14,2659,1249,3908
18/10/2018,#####,15,2643,1206,3849
18/10/2018,#####,16,2563,1196,3759
18/10/2018,#####,17,2305,1084,3389
18/10/2018,#####,18,2176,1141,3317
18/10/2018,#####,19,2130,1084,3214
18/10/2018,#####,20,1922,982,2904
18/10/2018,#####,21,1630,833,2463
18/10/2018,#####,22,1355,826,2181
18/10/2018,#####,23,1361,746,2107
19/10/2018,#####,0,975,692,1667
19/10/2018,#####,1,1060,673,1733
19/10/2018,#####,2,1017,664,1681
19/10/2018,#####,3,1025,687,1712
19/10/2018,#####,4,1054,700,1754
19/10/2018,#####,5,1067,754,1821
19/10/2018,#####,6,1170,886,2056
19/10/2018,#####,7,1396,882,2278
19/10/2018,#####,8,1552,934,2486
19/10/2018,#####,9,1566,938,2504
19/10/2018,#####,10,1731,1032,2763
19/10/2018,#####,11,1740,1098,2838
19/10/2018,#####,12,1736,996,2732
19/10/2018,#####,13,1745,883,2628
19/10/2018,#####,14,1669,800,2469
19/10/2018,#####,15,1767,801,2568
19/10/2018,#####,16,1601,892,2493
19/10/2018,#####,17,1731,947,2678
19/10/2018,#####,18,1543,1058,2601
19/10/2018,#####,19,1595,997,2592
19/10/2018,#####,20,1638,941,2579
19/10/2018,#####,21,1636,843,2479
19/10/2018,#####,22,1733,730,2463
19/10/2018,#####,23,1846,698,2544
20/10/2018,#####,0,1678,614,2292
20/10/2018,#####,1,1760,661,2421
20/10/2018,#####,2,1785,667,2452
20/10/2018,#####,3,1700,631,2331
20/10/2018,#####,4,1618,662,2280
20/10/2018,#####,5,1714,758,2472
20/10/2018,#####,6,1861,752,2613
20/10/2018,#####,7,2034,855,2889
20/10/2018,#####,8,2127,956,3083
20/10/2018,#####,9,2223,1064,3287
20/10/2018,#####,10,2328,1118,3446
20/10/2018,#####,11,2435,929,3364
20/10/2018,#####,12,2260,877,3137
20/10/2018,#####,13,2327,944,3271
20/10/2018,#####,14,2286,890,3176
20/10/2018,#####,15,2260,849,3109
20/10/2018,#####,16,2129,763,2892
20/10/2018,#####,17,2126,811,2937
20/10/2018,#####,18,2057,921,2978
20/10/2018,#####,19,1972,906,2878
20/10/2018,#####,20,1785,877,2662
20/10/2018,#####,21,1578,727,2305
20/10/2018,#####,22,1460,616,2076
20/10/2018,#####,23,1344,578,1922
21/10/2018,#####,0,1280,537,1817
21/10/2018,#####,1,1272,575,1847
21/10/2018,#####,2,1157,628,1785
21/10/2018,#####,3,1165,566,1731
21/10/2018,#####,4,1303,550,1853
21/10/2018,#####,5,1384,621,2005
21/10/2018,#####,6,1509,675,2184
21/10/2018,#####,7,1641,712,2353
21/10/2018,#####,8,1922,756,2678
21/10/2018,#####,9,2060,724,2784
21/10/2018,#####,10,2105,749,2854
21/10/2018,#####,11,2170,779,2949
21/10/2018,#####,12,2480,777,3257
21/10/2018,#####,13,2648,789,3437
21/10/2018,#####,14,2776,804,3580
21/10/2018,#####,15,2763,1040,3803
21/10/2018,#####,16,2825,1139,3964
21/10/2018,#####,17,2925,1107,4032
21/10/2018,#####,18,3009,1107,4116
21/10/2018,#####,19,2944,1114,4058
21/10/2018,#####,20,3030,1066,4096
21/10/2018,#####,21,2553,1109,3662
21/10/2018,#####,22,2524,1082,3606
21/10/2018,#####,23,2582,1089,3671
22/10/2018,#####,0,2169,1078,3247
22/10/2018,#####,1,2125,994,3119
22/10/2018,#####,2,2243,1035,3278
22/10/2018,#####,3,2437,1042,3479
22/10/2018,#####,4,2460,1005,3465
22/10/2018,#####,5,2566,1030,3596
22/10/2018,#####,6,2858,1026,3884
22/10/2018,#####,7,2839,1159,3998
22/10/2018,#####,8,2768,1337,4105
22/10/2018,#####,9,2916,1325,4241
22/10/2018,#####,10,3157,1270,4427
22/10/2018,#####,11,3601,1469,5070
22/10/2018,#####,12,3442,1503,4945
22/10/2018,#####,13,3394,1561,4955
22/10/2018,#####,14,3465,1504,4969
22/10/2018,#####,15,3402,1500,4902
22/10/2018,#####,16,3013,1417,4430
22/10/2018,#####,17,2827,1318,4145
22/10/2018,#####,18,2760,1280,4040
22/10/2018,#####,19,2795,1291,4086
22/10/2018,#####,20,2906,1292,4198
22/10/2018,#####,21,3181,1264,4445
22/10/2018,#####,22,3303,1310,4613
22/10/2018,#####,23,3338,1347,4685
23/10/2018,#####,0,3435,1355,4790
23/10/2018,#####,1,3210,1315,4525
23/10/2018,#####,2,3272,1332,4604
23/10/2018,#####,3,3316,1413,4729
23/10/2018,#####,4,3302,1492,4794
23/10/2018,#####,5,3209,1470,4679
23/10/2018,#####,6,3054,1540,4594
23/10/2018,#####,7,3139,1596,4735
23/10/2018,#####,8,3398,1606,5004
23/10/2018,#####,9,3833,1596,5429
23/10/2018,#####,10,4506,1600,6106
23/10/2018,#####,11,4643,1651,6294
23/10/2018,#####,12,4152,1585,5737
23/10/2018,#####,13,4336,1587,5923
23/10/2018,#####,14,4533,1569,6102
23/10/2018,#####,15,4005,1521,5526
23/10/2018,#####,16,3825,1514,5339
23/10/2018,#####,17,4146,1562,5708
23/10/2018,#####,18,4418,1539,5957
23/10/2018,#####,19,4355,1557,5912
23/10/2018,#####,20,4030,1585,5615
23/10/2018,#####,21,3872,1532,5404
23/10/2018,#####,22,3605,1437,5042
23/10/2018,#####,23,2800,1317,4117
24/10/2018,#####,0,2787,1419,4206
24/10/2018,#####,1,2750,1399,4149
24/10/2018,#####,2,2650,1355,4005
24/10/2018,#####,3,2705,1335,4040
24/10/2018,#####,4,3003,1383,4386
24/10/2018,#####,5,2582,1345,3927
24/10/2018,#####,6,2461,1339,3800
24/10/2018,#####,7,2377,1368,3745
24/10/2018,#####,8,2577,1401,3978
24/10/2018,#####,9,2322,1450,3772
24/10/2018,#####,10,2321,1492,3813
24/10/2018,#####,11,2388,1528,3916
24/10/2018,#####,12,2406,1501,3907
24/10/2018,#####,13,2275,1404,3679
24/10/2018,#####,14,2278,1316,3594
24/10/2018,#####,15,2465,1150,3615
24/10/2018,#####,16,2446,959,3405
24/10/2018,#####,17,2391,1031,3422
24/10/2018,#####,18,2233,825,3058
24/10/2018,#####,19,2278,939,3217
24/10/2018,#####,20,2700,1053,3753
24/10/2018,#####,21,3350,1048,4398
24/10/2018,#####,22,3382,1055,4437
24/10/2018,#####,23,3338,1247,4585
25/10/2018,#####,0,3242,1394,4636
25/10/2018,#####,1,3589,1439,5028
25/10/2018,#####,2,3555,1462,5017
25/10/2018,#####,3,3090,1450,4540
25/10/2018,#####,4,3207,1430,4637
25/10/2018,#####,5,3373,1455,4828
25/10/2018,#####,6,3417,1455,4872
25/10/2018,#####,7,3383,1471,4854
25/10/2018,#####,8,3439,1486,4925
25/10/2018,#####,9,3532,1541,5073
25/10/2018,#####,10,3531,1598,5129
25/10/2018,#####,11,3381,1649,5030
25/10/2018,#####,12,4017,1664,5681
25/10/2018,#####,13,3988,1666,5654
25/10/2018,#####,14,3799,1689,5488
25/10/2018,#####,15,3478,1621,5099
25/10/2018,#####,16,3422,1548,4970
25/10/2018,#####,17,3086,1406,4492
25/10/2018,#####,18,2811,1310,4121
25/10/2018,#####,19,3119,1316,4435
25/10/2018,#####,20,2952,1197,4149
25/10/2018,#####,21,3076,1099,4175
25/10/2018,#####,22,2886,1129,4015
25/10/2018,#####,23,2161,1167,3328
26/10/2018,#####,0,1945,1073,3018
26/10/2018,#####,1,2232,981,3213
26/10/2018,#####,2,2040,962,3002
26/10/2018,#####,3,1765,904,2669
26/10/2018,#####,4,1563,858,2421
26/10/2018,#####,5,1625,716,2341
26/10/2018,#####,6,2026,722,2748
26/10/2018,#####,7,2333,821,3154
26/10/2018,#####,8,2514,1008,3522
26/10/2018,#####,9,2624,1217,3841
26/10/2018,#####,10,2436,1270,3706
26/10/2018,#####,11,2529,1336,3865
26/10/2018,#####,12,2479,1335,3814
26/10/2018,#####,13,2188,1337,3525
26/10/2018,#####,14,2290,1283,3573
26/10/2018,#####,15,2365,1260,3625
26/10/2018,#####,16,2203,1209,3412
26/10/2018,#####,17,2345,1202,3547
26/10/2018,#####,18,2345,1153,3498
26/10/2018,#####,19,2366,1024,3390
26/10/2018,#####,20,2286,955,3241
26/10/2018,#####,21,2267,1120,3387
26/10/2018,#####,22,2365,1161,3526
26/10/2018,#####,23,2507,1315,3822
27/10/2018,#####,0,2637,1361,3998
27/10/2018,#####,1,2922,1390,4312
27/10/2018,#####,2,3027,1401,4428
27/10/2018,#####,3,3442,1387,4829
27/10/2018,#####,4,3531,1373,4904
27/10/2018,#####,5,3278,1336,4614
27/10/2018,#####,6,3094,1399,4493
27/10/2018,#####,7,2600,1418,4018
27/10/2018,#####,8,2717,1432,4149
27/10/2018,#####,9,3092,1553,4645
27/10/2018,#####,10,3196,1656,4852
27/10/2018,#####,11,3247,1615,4862
27/10/2018,#####,12,3229,1613,4842
27/10/2018,#####,13,3082,1553,4635
27/10/2018,#####,14,3012,1421,4433
27/10/2018,#####,15,2856,1312,4168
27/10/2018,#####,16,2541,1177,3718
27/10/2018,#####,17,2355,1070,3425
27/10/2018,#####,18,2399,907,3306
27/10/2018,#####,19,2221,1031,3252
27/10/2018,#####,20,2064,990,3054
27/10/2018,#####,21,1920,884,2804
27/10/2018,#####,22,1827,822,2649
27/10/2018,#####,23,1682,783,2465
28/10/2018,#####,0,1599,659,2258
28/10/2018,#####,1,1560,682,2242
28/10/2018,#####,2,1396,649,2045
28/10/2018,#####,3,1400,645,2045
28/10/2018,#####,4,1565,632,2197
28/10/2018,#####,5,1716,666,2382
28/10/2018,#####,6,1915,600,2515
28/10/2018,#####,7,2035,676,2711
28/10/2018,#####,8,2156,737,2893
28/10/2018,#####,9,2304,830,3134
28/10/2018,#####,10,2481,852,3333
28/10/2018,#####,11,2584,847,3431
28/10/2018,#####,12,2875,881,3756
28/10/2018,#####,13,2795,831,3626
28/10/2018,#####,14,2870,861,3731
28/10/2018,#####,15,2820,915,3735
28/10/2018,#####,16,2691,987,3678
28/10/2018,#####,17,2709,1043,3752
28/10/2018,#####,18,2899,1146,4045
28/10/2018,#####,19,3127,1143,4270
28/10/2018,#####,20,3160,1321,4481
28/10/2018,#####,21,3071,1281,4352
28/10/2018,#####,22,2998,1399,4397
28/10/2018,#####,23,2963,1404,4367
28/10/2018,#####,0,2634,1382,4016
29/10/2018,#####,1,2576,1399,3975
29/10/2018,#####,2,2798,1409,4207
29/10/2018,#####,3,2799,1402,4201
29/10/2018,#####,4,2926,1329,4255
29/10/2018,#####,5,2907,1368,4275
29/10/2018,#####,6,3141,1363,4504
29/10/2018,#####,7,3248,1418,4666
29/10/2018,#####,8,3882,1503,5385
29/10/2018,#####,9,3658,1561,5219
29/10/2018,#####,10,3654,1625,5279
29/10/2018,#####,11,3582,1660,5242
29/10/2018,#####,12,4293,1668,5961
29/10/2018,#####,13,4358,1696,6054
29/10/2018,#####,14,4389,1594,5983
29/10/2018,#####,15,4359,1563,5922
29/10/2018,#####,16,4165,1500,5665
29/10/2018,#####,17,4175,1547,5722
29/10/2018,#####,18,4145,1597,5742
29/10/2018,#####,19,4240,1594,5834
29/10/2018,#####,20,4470,1604,6074
29/10/2018,#####,21,4323,1583,5906
29/10/2018,#####,22,4282,1457,5739
29/10/2018,#####,23,3968,1445,5413
29/10/2018,#####,0,3832,1441,5273
30/10/2018,#####,1,3712,1463,5175
30/10/2018,#####,2,3675,1404,5079
30/10/2018,#####,3,3672,1389,5061
30/10/2018,#####,4,3714,1439,5153
30/10/2018,#####,5,3779,1435,5214
30/10/2018,#####,6,3856,1450,5306
30/10/2018,#####,7,3937,1498,5435
30/10/2018,#####,8,4208,1517,5725
30/10/2018,#####,9,4301,1470,5771
30/10/2018,#####,10,4186,1235,5421
30/10/2018,#####,11,3964,1119,5083
30/10/2018,#####,12,3804,1225,5029
30/10/2018,#####,13,3471,1386,4857
30/10/2018,#####,14,3261,1366,4627
30/10/2018,#####,15,3004,1467,4471
30/10/2018,#####,16,2997,1350,4347
30/10/2018,#####,17,2956,1246,4202
30/10/2018,#####,18,3051,1003,4054
30/10/2018,#####,19,3177,835,4012
30/10/2018,#####,20,2520,917,3437
30/10/2018,#####,21,1891,1137,3028
30/10/2018,#####,22,1638,1279,2917
30/10/2018,#####,23,1639,1303,2942
30/10/2018,#####,0,1608,1322,2930
31/10/2018,#####,1,1883,1199,3082
31/10/2018,#####,2,1991,1309,3300
31/10/2018,#####,3,2275,1363,3638
31/10/2018,#####,4,2384,1370,3754
31/10/2018,#####,5,2456,1374,3830
31/10/2018,#####,6,2770,1347,4117
31/10/2018,#####,7,2679,1380,4059
31/10/2018,#####,8,2937,1464,4401
31/10/2018,#####,9,3267,1528,4795
31/10/2018,#####,10,3380,1531,4911
31/10/2018,#####,11,3538,1520,5058
31/10/2018,#####,12,3637,1546,5183
31/10/2018,#####,13,3308,1475,4783
31/10/2018,#####,14,3233,1320,4553
31/10/2018,#####,15,2983,1146,4129
31/10/2018,#####,16,2630,1006,3636
31/10/2018,#####,17,2476,895,3371
31/10/2018,#####,18,2424,1031,3455
31/10/2018,#####,19,2476,938,3414
31/10/2018,#####,20,2573,859,3432
31/10/2018,#####,21,2489,808,3297
31/10/2018,#####,22,2299,810,3109
31/10/2018,#####,23,1829,817,2646
31/10/2018,#####,0,1588,798,2386
01/11/2018,#####,1,1797,746,2543
01/11/2018,#####,2,1944,753,2697
01/11/2018,#####,3,2042,818,2860
01/11/2018,#####,4,2167,799,2966
01/11/2018,#####,5,2342,793,3135
01/11/2018,#####,6,2577,826,3403
01/11/2018,#####,7,3035,840,3875
01/11/2018,#####,8,3196,782,3978
01/11/2018,#####,9,3254,871,4125
01/11/2018,#####,10,3202,966,4168
01/11/2018,#####,11,3215,1002,4217
01/11/2018,#####,12,3005,1035,4040
01/11/2018,#####,13,2874,914,3788
01/11/2018,#####,14,2765,854,3619
01/11/2018,#####,15,2587,809,3396
01/11/2018,#####,16,2489,765,3254
01/11/2018,#####,17,2728,797,3525
01/11/2018,#####,18,2719,791,3510
01/11/2018,#####,19,2804,810,3614
01/11/2018,#####,20,2535,784,3319
01/11/2018,#####,21,2330,732,3062
01/11/2018,#####,22,1807,653,2460
01/11/2018,#####,23,1469,651,2120
01/11/2018,#####,0,1012,664,1676
02/11/2018,#####,1,962,748,1710
02/11/2018,#####,2,1084,751,1835
02/11/2018,#####,3,1151,728,1879
02/11/2018,#####,4,1282,748,2030
02/11/2018,#####,5,1462,875,2337
02/11/2018,#####,6,1756,903,2659
02/11/2018,#####,7,2175,1009,3184
02/11/2018,#####,8,2627,1158,3785
02/11/2018,#####,9,2787,1233,4020
02/11/2018,#####,10,2658,1387,4045
02/11/2018,#####,11,2743,1452,4195
02/11/2018,#####,12,3032,1586,4618
02/11/2018,#####,13,2974,1607,4581
02/11/2018,#####,14,3061,1524,4585
02/11/2018,#####,15,3090,1492,4582
02/11/2018,#####,16,3509,1427,4936
02/11/2018,#####,17,3401,1398,4799
02/11/2018,#####,18,3396,1369,4765
02/11/2018,#####,19,3292,1283,4575
02/11/2018,#####,20,3024,1105,4129
02/11/2018,#####,21,2632,1036,3668
02/11/2018,#####,22,2393,948,3341
02/11/2018,#####,23,2200,852,3052
02/11/2018,#####,0,1998,793,2791
03/11/2018,#####,1,1908,808,2716
03/11/2018,#####,2,1908,764,2672
03/11/2018,#####,3,1825,741,2566
03/11/2018,#####,4,1634,709,2343
03/11/2018,#####,5,1598,670,2268
03/11/2018,#####,6,1487,638,2125
03/11/2018,#####,7,1802,640,2442
03/11/2018,#####,8,1893,686,2579
03/11/2018,#####,9,2243,735,2978
03/11/2018,#####,10,2361,843,3204
03/11/2018,#####,11,2383,865,3248
03/11/2018,#####,12,2595,867,3462
03/11/2018,#####,13,2785,918,3703
03/11/2018,#####,14,2931,871,3802
03/11/2018,#####,15,2769,823,3592
03/11/2018,#####,16,2693,760,3453
03/11/2018,#####,17,2923,840,3763
03/11/2018,#####,18,3065,844,3909
03/11/2018,#####,19,3147,798,3945
03/11/2018,#####,20,2997,764,3761
03/11/2018,#####,21,2923,726,3649
03/11/2018,#####,22,2807,753,3560
03/11/2018,#####,23,2642,753,3395
03/11/2018,#####,0,2609,735,3344
04/11/2018,#####,1,2407,710,3117
04/11/2018,#####,2,2325,650,2975
04/11/2018,#####,3,2315,654,2969
04/11/2018,#####,4,2367,701,3068
04/11/2018,#####,5,2319,753,3072
04/11/2018,#####,6,2250,781,3031
04/11/2018,#####,7,2251,835,3086
04/11/2018,#####,8,2411,908,3319
04/11/2018,#####,9,2580,971,3551
04/11/2018,#####,10,2631,978,3609
04/11/2018,#####,11,2520,950,3470
04/11/2018,#####,12,2490,965,3455
04/11/2018,#####,13,2386,961,3347
04/11/2018,#####,14,2241,898,3139
04/11/2018,#####,15,2319,901,3220
04/11/2018,#####,16,2389,883,3272
04/11/2018,#####,17,2299,842,3141
04/11/2018,#####,18,2342,831,3173
04/11/2018,#####,19,2337,817,3154
04/11/2018,#####,20,2323,774,3097
04/11/2018,#####,21,2166,764,2930
04/11/2018,#####,22,1983,712,2695
04/11/2018,#####,23,1773,683,2456
04/11/2018,#####,0,1375,636,2011
05/11/2018,#####,1,1148,666,1814
05/11/2018,#####,2,1092,683,1775
05/11/2018,#####,3,1103,671,1774
05/11/2018,#####,4,1102,620,1722
05/11/2018,#####,5,1127,615,1742
05/11/2018,#####,6,1225,667,1892
05/11/2018,#####,7,1687,728,2415
05/11/2018,#####,8,1865,855,2720
05/11/2018,#####,9,1851,912,2763
05/11/2018,#####,10,1921,900,2821
05/11/2018,#####,11,2050,884,2934
05/11/2018,#####,12,2011,955,2966
05/11/2018,#####,13,1926,980,2906
05/11/2018,#####,14,1922,969,2891
05/11/2018,#####,15,1989,998,2987
05/11/2018,#####,16,1991,902,2893
05/11/2018,#####,17,2152,941,3093
05/11/2018,#####,18,2125,941,3066
05/11/2018,#####,19,2017,928,2945
05/11/2018,#####,20,1985,909,2894
05/11/2018,#####,21,1995,858,2853
05/11/2018,#####,22,1848,827,2675
05/11/2018,#####,23,1796,855,2651
05/11/2018,#####,0,1623,869,2492
06/11/2018,#####,1,1432,783,2215
06/11/2018,#####,2,1580,768,2348
06/11/2018,#####,3,1419,746,2165
06/11/2018,#####,4,1332,764,2096
06/11/2018,#####,5,1326,751,2077
06/11/2018,#####,6,1481,754,2235
06/11/2018,#####,7,1771,769,2540
06/11/2018,#####,8,1903,830,2733
06/11/2018,#####,9,1835,888,2723
06/11/2018,#####,10,1925,873,2798
06/11/2018,#####,11,1924,838,2762
06/11/2018,#####,12,1841,769,2610
06/11/2018,#####,13,1837,750,2587
06/11/2018,#####,14,1722,741,2463
06/11/2018,#####,15,1728,760,2488
06/11/2018,#####,16,1711,789,2500
06/11/2018,#####,17,1698,741,2439
06/11/2018,#####,18,1833,800,2633
06/11/2018,#####,19,1884,803,2687
06/11/2018,#####,20,1850,738,2588
06/11/2018,#####,21,1733,689,2422
06/11/2018,#####,22,1581,619,2200
06/11/2018,#####,23,1381,559,1940
06/11/2018,#####,0,1195,514,1709
07/11/2018,#####,1,1114,599,1713
07/11/2018,#####,2,1206,593,1799
07/11/2018,#####,3,1400,662,2062
07/11/2018,#####,4,1455,692,2147
07/11/2018,#####,5,1602,706,2308
07/11/2018,#####,6,1994,680,2674
07/11/2018,#####,7,2064,750,2814
07/11/2018,#####,8,2524,829,3353
07/11/2018,#####,9,2614,774,3388
07/11/2018,#####,10,2542,717,3259
07/11/2018,#####,11,2372,784,3156
07/11/2018,#####,12,2292,760,3052
07/11/2018,#####,13,2251,771,3022
07/11/2018,#####,14,2163,975,3138
07/11/2018,#####,15,2066,864,2930
07/11/2018,#####,16,2148,880,3028
07/11/2018,#####,17,2266,983,3249
07/11/2018,#####,18,2226,988,3214
07/11/2018,#####,19,1975,949,2924
07/11/2018,#####,20,1854,945,2799
07/11/2018,#####,21,1628,980,2608
07/11/2018,#####,22,1332,792,2124
07/11/2018,#####,23,1254,788,2042
07/11/2018,#####,0,1355,731,2086
08/11/2018,#####,1,1234,646,1880
08/11/2018,#####,2,1189,628,1817
08/11/2018,#####,3,1279,603,1882
08/11/2018,#####,4,1439,592,2031
08/11/2018,#####,5,1424,632,2056
08/11/2018,#####,6,1588,662,2250
08/11/2018,#####,7,1869,795,2664
08/11/2018,#####,8,1992,1028,3020
08/11/2018,#####,9,2073,1022,3095
08/11/2018,#####,10,1994,906,2900
08/11/2018,#####,11,1866,876,2742
08/11/2018,#####,12,1915,890,2805
08/11/2018,#####,13,1842,962,2804
08/11/2018,#####,14,1950,955,2905
08/11/2018,#####,15,2110,967,3077
08/11/2018,#####,16,1938,950,2888
08/11/2018,#####,17,1888,928,2816
08/11/2018,#####,18,2069,990,3059
08/11/2018,#####,19,1862,994,2856
08/11/2018,#####,20,1798,988,2786
08/11/2018,#####,21,1584,958,2542
08/11/2018,#####,22,1254,847,2101
08/11/2018,#####,23,1106,689,1795
08/11/2018,#####,0,863,598,1461
09/11/2018,#####,1,782,586,1368
09/11/2018,#####,2,765,570,1335
09/11/2018,#####,3,785,564,1349
09/11/2018,#####,4,812,615,1427
09/11/2018,#####,5,707,617,1324
09/11/2018,#####,6,896,690,1586
09/11/2018,#####,7,1567,730,2297
09/11/2018,#####,8,1833,935,2768
09/11/2018,#####,9,1887,974,2861
09/11/2018,#####,10,1853,993,2846
09/11/2018,#####,11,1930,1014,2944
09/11/2018,#####,12,2179,1042,3221
09/11/2018,#####,13,2163,1075,3238
09/11/2018,#####,14,1971,1087,3058
09/11/2018,#####,15,1789,1111,2900
09/11/2018,#####,16,1945,1164,3109
09/11/2018,#####,17,2472,1280,3752
09/11/2018,#####,18,2630,1324,3954
09/11/2018,#####,19,2816,1335,4151
09/11/2018,#####,20,2717,1364,4081
09/11/2018,#####,21,2364,1117,3481
09/11/2018,#####,22,2378,1036,3414
09/11/2018,#####,23,2276,1059,3335
09/11/2018,#####,0,1842,1011,2853
10/11/2018,#####,1,1962,1003,2965
10/11/2018,#####,2,1866,977,2843
10/11/2018,#####,3,1937,917,2854
10/11/2018,#####,4,2036,832,2868
10/11/2018,#####,5,2341,907,3248
10/11/2018,#####,6,2565,956,3521
10/11/2018,#####,7,2891,997,3888
10/11/2018,#####,8,3096,1004,4100
10/11/2018,#####,9,3202,1039,4241
10/11/2018,#####,10,3487,1104,4591
10/11/2018,#####,11,3585,1190,4775
10/11/2018,#####,12,3803,1232,5035
10/11/2018,#####,13,3661,1155,4816
10/11/2018,#####,14,3396,1149,4545
10/11/2018,#####,15,3309,1084,4393
10/11/2018,#####,16,2973,1111,4084
10/11/2018,#####,17,2924,1123,4047
10/11/2018,#####,18,2836,1136,3972
10/11/2018,#####,19,2746,1101,3847
10/11/2018,#####,20,2424,1154,3578
10/11/2018,#####,21,2373,1101,3474
10/11/2018,#####,22,2400,1069,3469
10/11/2018,#####,23,2366,1072,3438
10/11/2018,#####,0,2278,1074,3352
11/11/2018,#####,1,2504,1151,3655
11/11/2018,#####,2,2485,1119,3604
11/11/2018,#####,3,2445,1109,3554
11/11/2018,#####,4,2181,1129,3310
11/11/2018,#####,5,1986,1086,3072
11/11/2018,#####,6,1995,1061,3056
11/11/2018,#####,7,1924,1069,2993
11/11/2018,#####,8,2121,1064,3185
11/11/2018,#####,9,2203,1031,3234
11/11/2018,#####,10,2166,1006,3172
11/11/2018,#####,11,1974,1004,2978
11/11/2018,#####,12,2201,970,3171
11/11/2018,#####,13,2546,1022,3568
11/11/2018,#####,14,2588,1051,3639
11/11/2018,#####,15,2358,1021,3379
11/11/2018,#####,16,2286,1047,3333
11/11/2018,#####,17,2447,1022,3469
11/11/2018,#####,18,2235,988,3223
11/11/2018,#####,19,1784,1024,2808
11/11/2018,#####,20,1776,1092,2868
11/11/2018,#####,21,2044,1047,3091
11/11/2018,#####,22,2332,1095,3427
11/11/2018,#####,23,2312,1000,3312
11/11/2018,#####,0,2520,809,3329
12/11/2018,#####,1,2020,842,2862
12/11/2018,#####,2,2129,891,3020
12/11/2018,#####,3,2066,896,2962
12/11/2018,#####,4,1918,839,2757
12/11/2018,#####,5,1883,774,2657
12/11/2018,#####,6,1889,745,2634
12/11/2018,#####,7,1956,774,2730
12/11/2018,#####,8,2253,888,3141
12/11/2018,#####,9,2332,858,3190
12/11/2018,#####,10,2098,855,2953
12/11/2018,#####,11,2153,834,2987
12/11/2018,#####,12,2323,973,3296
12/11/2018,#####,13,2242,1102,3344
12/11/2018,#####,14,2057,1133,3190
12/11/2018,#####,15,1850,1044,2894
12/11/2018,#####,16,1848,1102,2950
12/11/2018,#####,17,1820,1026,2846
12/11/2018,#####,18,1899,944,2843
12/11/2018,#####,19,1935,943,2878
12/11/2018,#####,20,1788,961,2749
12/11/2018,#####,21,1594,923,2517
12/11/2018,#####,22,1362,916,2278
12/11/2018,#####,23,1183,794,1977
12/11/2018,#####,0,1150,821,1971
13/11/2018,#####,1,1334,799,2133
13/11/2018,#####,2,1516,825,2341
13/11/2018,#####,3,1429,760,2189
13/11/2018,#####,4,1476,754,2230
13/11/2018,#####,5,1544,760,2304
13/11/2018,#####,6,2054,802,2856
13/11/2018,#####,7,1888,862,2750
13/11/2018,#####,8,2188,887,3075
13/11/2018,#####,9,2112,883,2995
13/11/2018,#####,10,2368,912,3280
13/11/2018,#####,11,2427,1095,3522
13/11/2018,#####,12,2555,1146,3701
13/11/2018,#####,13,2682,1224,3906
13/11/2018,#####,14,2637,1292,3929
13/11/2018,#####,15,2750,1280,4030
13/11/2018,#####,16,2195,1244,3439
13/11/2018,#####,17,1974,1290,3264
13/11/2018,#####,18,2248,1374,3622
13/11/2018,#####,19,2018,1491,3509
13/11/2018,#####,20,2125,1387,3512
13/11/2018,#####,21,1792,1269,3061
13/11/2018,#####,22,1336,1236,2572
13/11/2018,#####,23,1343,1134,2477
13/11/2018,#####,0,1565,1163,2728
14/11/2018,#####,1,1805,1230,3035
14/11/2018,#####,2,1530,1207,2737
14/11/2018,#####,3,1436,1179,2615
14/11/2018,#####,4,1547,1048,2595
14/11/2018,#####,5,1283,985,2268
14/11/2018,#####,6,1503,850,2353
14/11/2018,#####,7,1698,957,2655
14/11/2018,#####,8,2134,1050,3184
14/11/2018,#####,9,2283,1135,3418
14/11/2018,#####,10,2422,1176,3598
14/11/2018,#####,11,2533,1200,3733
14/11/2018,#####,12,2533,1129,3662
14/11/2018,#####,13,2631,1062,3693
14/11/2018,#####,14,2706,1107,3813
14/11/2018,#####,15,2741,1075,3816
14/11/2018,#####,16,2715,1085,3800
14/11/2018,#####,17,2728,1104,3832
14/11/2018,#####,18,2826,1093,3919
14/11/2018,#####,19,2863,1100,3963
14/11/2018,#####,20,2758,995,3753
14/11/2018,#####,21,2594,982,3576
14/11/2018,#####,22,2067,796,2863
14/11/2018,#####,23,2075,773,2848
14/11/2018,#####,0,2057,749,2806
15/11/2018,#####,1,2199,717,2916
15/11/2018,#####,2,2187,623,2810
15/11/2018,#####,3,2036,615,2651
15/11/2018,#####,4,1657,628,2285
15/11/2018,#####,5,1656,657,2313
15/11/2018,#####,6,1921,665,2586
15/11/2018,#####,7,2320,744,3064
15/11/2018,#####,8,2460,931,3391
15/11/2018,#####,9,2409,952,3361
15/11/2018,#####,10,2413,895,3308
15/11/2018,#####,11,2383,1046,3429
15/11/2018,#####,12,2286,786,3072
15/11/2018,#####,13,2208,807,3015
15/11/2018,#####,14,2210,783,2993
15/11/2018,#####,15,2266,883,3149
15/11/2018,#####,16,2354,1008,3362
15/11/2018,#####,17,2536,1026,3562
15/11/2018,#####,18,2664,1109,3773
15/11/2018,#####,19,2681,1153,3834
15/11/2018,#####,20,2435,1159,3594
15/11/2018,#####,21,2420,1128,3548
15/11/2018,#####,22,2221,986,3207
15/11/2018,#####,23,2258,945,3203
15/11/2018,#####,0,1901,923,2824
16/11/2018,#####,1,1904,951,2855
16/11/2018,#####,2,1814,1011,2825
16/11/2018,#####,3,1818,1025,2843
16/11/2018,#####,4,1797,1020,2817
16/11/2018,#####,5,1765,1049,2814
16/11/2018,#####,6,1957,1112,3069
16/11/2018,#####,7,2207,1098,3305
16/11/2018,#####,8,2491,1134,3625
16/11/2018,#####,9,2444,1173,3617
16/11/2018,#####,10,2283,1210,3493
16/11/2018,#####,11,2323,1227,3550
16/11/2018,#####,12,2250,1184,3434
16/11/2018,#####,13,2357,1172,3529
16/11/2018,#####,14,2054,1098,3152
16/11/2018,#####,15,2145,1030,3175
16/11/2018,#####,16,2139,1012,3151
16/11/2018,#####,17,2500,1027,3527
16/11/2018,#####,18,2498,1076,3574
16/11/2018,#####,19,2573,1214,3787
16/11/2018,#####,20,2389,1263,3652
16/11/2018,#####,21,1875,1190,3065
16/11/2018,#####,22,1770,1105,2875
16/11/2018,#####,23,1811,1028,2839
16/11/2018,#####,0,1948,966,2914
17/11/2018,#####,1,1969,849,2818
17/11/2018,#####,2,1689,756,2445
17/11/2018,#####,3,1661,720,2381
17/11/2018,#####,4,1435,681,2116
17/11/2018,#####,5,1388,701,2089
17/11/2018,#####,6,1312,733,2045
17/11/2018,#####,7,1579,739,2318
17/11/2018,#####,8,1452,704,2156
17/11/2018,#####,9,1625,727,2352
17/11/2018,#####,10,1716,727,2443
17/11/2018,#####,11,2073,724,2797
17/11/2018,#####,12,2024,744,2768
17/11/2018,#####,13,2007,741,2748
17/11/2018,#####,14,1796,734,2530
17/11/2018,#####,15,1802,769,2571
17/11/2018,#####,16,1902,806,2708
17/11/2018,#####,17,1876,805,2681
17/11/2018,#####,18,1953,767,2720
17/11/2018,#####,19,1873,757,2630
17/11/2018,#####,20,1572,748,2320
17/11/2018,#####,21,1370,707,2077
17/11/2018,#####,22,1255,685,1940
17/11/2018,#####,23,1283,677,1960
17/11/2018,#####,0,1238,659,1897
18/11/2018,#####,1,1170,663,1833
18/11/2018,#####,2,1077,650,1727
18/11/2018,#####,3,1042,634,1676
18/11/2018,#####,4,1158,649,1807
18/11/2018,#####,5,1163,667,1830
18/11/2018,#####,6,1184,750,1934
18/11/2018,#####,7,1413,732,2145
18/11/2018,#####,8,1548,731,2279
18/11/2018,#####,9,1918,803,2721
18/11/2018,#####,10,2083,937,3020
18/11/2018,#####,11,2263,1050,3313
18/11/2018,#####,12,2392,1054,3446
18/11/2018,#####,13,2479,1083,3562
18/11/2018,#####,14,2351,1088,3439
18/11/2018,#####,15,2576,1139,3715
18/11/2018,#####,16,2675,1173,3848
18/11/2018,#####,17,3060,1222,4282
18/11/2018,#####,18,3264,1264,4528
18/11/2018,#####,19,2711,1258,3969
18/11/2018,#####,20,2397,1255,3652
18/11/2018,#####,21,2451,1294,3745
18/11/2018,#####,22,2489,1311,3800
18/11/2018,#####,23,2203,1294,3497
18/11/2018,#####,0,2071,1236,3307
19/11/2018,#####,1,1924,1232,3156
19/11/2018,#####,2,1999,1282,3281
19/11/2018,#####,3,2143,1319,3462
19/11/2018,#####,4,2264,1347,3611
19/11/2018,#####,5,2447,1376,3823
19/11/2018,#####,6,2667,1380,4047
19/11/2018,#####,7,2725,1391,4116
19/11/2018,#####,8,2411,1435,3846
19/11/2018,#####,9,2675,1450,4125
19/11/2018,#####,10,2727,1485,4212
19/11/2018,#####,11,2942,1508,4450
19/11/2018,#####,12,2988,1455,4443
19/11/2018,#####,13,3106,1442,4548
19/11/2018,#####,14,2898,1474,4372
19/11/2018,#####,15,2770,1463,4233
19/11/2018,#####,16,2812,1505,4317
19/11/2018,#####,17,2999,1432,4431
19/11/2018,#####,18,2884,1425,4309
19/11/2018,#####,19,3563,1395,4958
19/11/2018,#####,20,3559,1344,4903
19/11/2018,#####,21,3166,1307,4473
19/11/2018,#####,22,3413,1289,4702
19/11/2018,#####,23,3313,1283,4596
19/11/2018,#####,0,3107,1293,4400
20/11/2018,#####,1,3027,1279,4306
20/11/2018,#####,2,2916,1297,4213
20/11/2018,#####,3,2784,1275,4059
20/11/2018,#####,4,2843,1302,4145
20/11/2018,#####,5,2929,1291,4220
20/11/2018,#####,6,3057,1299,4356
20/11/2018,#####,7,3511,1356,4867
20/11/2018,#####,8,3474,1396,4870
20/11/2018,#####,9,3111,1401,4512
20/11/2018,#####,10,3453,1399,4852
20/11/2018,#####,11,3592,1461,5053
20/11/2018,#####,12,3515,1482,4997
20/11/2018,#####,13,3994,1516,5510
20/11/2018,#####,14,3745,1541,5286
20/11/2018,#####,15,3444,1556,5000
20/11/2018,#####,16,3451,1567,5018
20/11/2018,#####,17,3404,1572,4976
20/11/2018,#####,18,3409,1608,5017
20/11/2018,#####,19,3581,1627,5208
20/11/2018,#####,20,3727,1551,5278
20/11/2018,#####,21,3341,1572,4913
20/11/2018,#####,22,3221,1573,4794
20/11/2018,#####,23,3367,1584,4951
20/11/2018,#####,0,3604,1558,5162
21/11/2018,#####,1,3110,1560,4670
21/11/2018,#####,2,3411,1547,4958
21/11/2018,#####,3,3310,1455,4765
21/11/2018,#####,4,3444,1460,4904
21/11/2018,#####,5,3697,1462,5159
21/11/2018,#####,6,3562,1606,5168
21/11/2018,#####,7,3293,1605,4898
21/11/2018,#####,8,3566,1646,5212
21/11/2018,#####,9,3683,1667,5350
21/11/2018,#####,10,3533,1679,5212
21/11/2018,#####,11,3692,1677,5369
21/11/2018,#####,12,3627,1735,5362
21/11/2018,#####,13,3725,1741,5466
21/11/2018,#####,14,3756,1778,5534
21/11/2018,#####,15,3627,1770,5397
21/11/2018,#####,16,3435,1738,5173
21/11/2018,#####,17,3409,1728,5137
21/11/2018,#####,18,3302,1740,5042
21/11/2018,#####,19,3513,1675,5188
21/11/2018,#####,20,3570,1620,5190
21/11/2018,#####,21,3396,1512,4908
21/11/2018,#####,22,3089,1368,4457
21/11/2018,#####,23,2641,1306,3947
21/11/2018,#####,0,2301,1214,3515
22/11/2018,#####,1,2167,1044,3211
22/11/2018,#####,2,2125,999,3124
22/11/2018,#####,3,1948,1021,2969
22/11/2018,#####,4,1880,979,2859
22/11/2018,#####,5,1982,962,2944
22/11/2018,#####,6,1976,1005,2981
22/11/2018,#####,7,2168,1071,3239
22/11/2018,#####,8,2454,1195,3649
22/11/2018,#####,9,2583,1227,3810
22/11/2018,#####,10,2675,1245,3920
22/11/2018,#####,11,2695,1294,3989
22/11/2018,#####,12,2692,1343,4035
22/11/2018,#####,13,2578,1341,3919
22/11/2018,#####,14,2630,1318,3948
22/11/2018,#####,15,2743,1335,4078
22/11/2018,#####,16,2645,1234,3879
22/11/2018,#####,17,2706,1235,3941
22/11/2018,#####,18,2642,1238,3880
22/11/2018,#####,19,2545,1248,3793
22/11/2018,#####,20,2430,1175,3605
22/11/2018,#####,21,2356,1077,3433
22/11/2018,#####,22,2273,888,3161
22/11/2018,#####,23,1991,848,2839
22/11/2018,#####,0,1831,691,2522
23/11/2018,#####,1,1620,656,2276
23/11/2018,#####,2,1604,665,2269
23/11/2018,#####,3,1635,680,2315
23/11/2018,#####,4,1599,691,2290
23/11/2018,#####,5,1639,710,2349
23/11/2018,#####,6,1774,787,2561
23/11/2018,#####,7,2167,920,3087
23/11/2018,#####,8,2511,976,3487
23/11/2018,#####,9,2544,1272,3816
23/11/2018,#####,10,2445,1273,3718
23/11/2018,#####,11,2341,1153,3494
23/11/2018,#####,12,2203,1040,3243
23/11/2018,#####,13,2192,1028,3220
23/11/2018,#####,14,2098,997,3095
23/11/2018,#####,15,2128,1004,3132
23/11/2018,#####,16,2106,1015,3121
23/11/2018,#####,17,2057,998,3055
23/11/2018,#####,18,2113,991,3104
23/11/2018,#####,19,2103,998,3101
23/11/2018,#####,20,1975,969,2944
23/11/2018,#####,21,1826,897,2723
23/11/2018,#####,22,1705,781,2486
23/11/2018,#####,23,1505,772,2277
23/11/2018,#####,0,1435,736,2171
24/11/2018,#####,1,1209,699,1908
24/11/2018,#####,2,1141,570,1711
24/11/2018,#####,3,1086,580,1666
24/11/2018,#####,4,1049,610,1659
24/11/2018,#####,5,1072,591,1663
24/11/2018,#####,6,996,655,1651
24/11/2018,#####,7,1157,644,1801
24/11/2018,#####,8,1378,711,2089
24/11/2018,#####,9,1559,798,2357
24/11/2018,#####,10,1661,877,2538
24/11/2018,#####,11,1793,892,2685
24/11/2018,#####,12,1795,910,2705
24/11/2018,#####,13,1794,855,2649
24/11/2018,#####,14,1838,831,2669
24/11/2018,#####,15,1953,851,2804
24/11/2018,#####,16,2097,879,2976
24/11/2018,#####,17,2386,1003,3389
24/11/2018,#####,18,2540,997,3537
24/11/2018,#####,19,2405,958,3363
24/11/2018,#####,20,2348,829,3177
24/11/2018,#####,21,2031,808,2839
24/11/2018,#####,22,1988,755,2743
24/11/2018,#####,23,2153,769,2922
24/11/2018,#####,0,2174,734,2908
25/11/2018,#####,1,1958,679,2637
25/11/2018,#####,2,1926,755,2681
25/11/2018,#####,3,1867,788,2655
25/11/2018,#####,4,1723,833,2556
25/11/2018,#####,5,1748,809,2557
25/11/2018,#####,6,1859,898,2757
25/11/2018,#####,7,2027,915,2942
25/11/2018,#####,8,2213,921,3134
25/11/2018,#####,9,2369,910,3279
25/11/2018,#####,10,2272,1010,3282
25/11/2018,#####,11,2393,1049,3442
25/11/2018,#####,12,2391,1056,3447
25/11/2018,#####,13,2552,1074,3626
25/11/2018,#####,14,2469,1085,3554
25/11/2018,#####,15,2386,1117,3503
25/11/2018,#####,16,2342,1169,3511
25/11/2018,#####,17,2478,1261,3739
25/11/2018,#####,18,2526,1313,3839
25/11/2018,#####,19,2538,1376,3914
25/11/2018,#####,20,2483,1365,3848
25/11/2018,#####,21,2330,1352,3682
25/11/2018,#####,22,2173,1291,3464
25/11/2018,#####,23,2077,1247,3324
25/11/2018,#####,0,1867,1154,3021
26/11/2018,#####,1,1683,1170,2853
26/11/2018,#####,2,1481,1115,2596
26/11/2018,#####,3,1268,1030,2298
26/11/2018,#####,4,1222,1000,2222
26/11/2018,#####,5,1220,994,2214
26/11/2018,#####,6,1516,1056,2572
26/11/2018,#####,7,1731,1155,2886
26/11/2018,#####,8,1892,1251,3143
26/11/2018,#####,9,1859,1266,3125
26/11/2018,#####,10,1824,1290,3114
26/11/2018,#####,11,1787,1286,3073
26/11/2018,#####,12,1692,1260,2952
26/11/2018,#####,13,1696,1294,2990
26/11/2018,#####,14,1712,1249,2961
26/11/2018,#####,15,1650,1233,2883
26/11/2018,#####,16,1691,1272,2963
26/11/2018,#####,17,1766,1311,3077
26/11/2018,#####,18,1838,1325,3163
26/11/2018,#####,19,1828,1308,3136
26/11/2018,#####,20,1767,1184,2951
26/11/2018,#####,21,1708,1110,2818
26/11/2018,#####,22,1690,1122,2812
26/11/2018,#####,23,1708,1036,2744
26/11/2018,#####,0,1505,970,2475
27/11/2018,#####,1,1524,978,2502
27/11/2018,#####,2,1473,971,2444
27/11/2018,#####,3,1518,919,2437
27/11/2018,#####,4,1471,923,2394
27/11/2018,#####,5,1416,942,2358
27/11/2018,#####,6,1488,910,2398
27/11/2018,#####,7,1675,965,2640
27/11/2018,#####,8,1889,1123,3012
27/11/2018,#####,9,1988,1186,3174
27/11/2018,#####,10,1925,1192,3117
27/11/2018,#####,11,2079,1207,3286
27/11/2018,#####,12,2090,1208,3298
27/11/2018,#####,13,2126,1215,3341
27/11/2018,#####,14,2150,1207,3357
27/11/2018,#####,15,2149,1161,3310
27/11/2018,#####,16,2177,1130,3307
27/11/2018,#####,17,2310,1164,3474
27/11/2018,#####,18,2523,1173,3696
27/11/2018,#####,19,2595,1167,3762
27/11/2018,#####,20,2524,1167,3691
27/11/2018,#####,21,2521,1170,3691
27/11/2018,#####,22,2408,1059,3467
27/11/2018,#####,23,2376,988,3364
27/11/2018,#####,0,2481,987,3468
28/11/2018,#####,1,2149,989,3138
28/11/2018,#####,2,2384,1087,3471
28/11/2018,#####,3,2479,1039,3518
28/11/2018,#####,4,2531,1063,3594
28/11/2018,#####,5,2470,1092,3562
28/11/2018,#####,6,2913,1153,4066
28/11/2018,#####,7,2374,1326,3700
28/11/2018,#####,8,2891,1517,4408
28/11/2018,#####,9,3237,1531,4768
28/11/2018,#####,10,3582,1658,5240
28/11/2018,#####,11,3737,1692,5429
28/11/2018,#####,12,4112,1759,5871
28/11/2018,#####,13,4045,1845,5890
28/11/2018,#####,14,4020,1904,5924
28/11/2018,#####,15,4069,1971,6040
28/11/2018,#####,16,3767,2002,5769
28/11/2018,#####,17,3869,1995,5864
28/11/2018,#####,18,3955,1999,5954
28/11/2018,#####,19,3664,1923,5587
28/11/2018,#####,20,3685,1917,5602
28/11/2018,#####,21,3985,1877,5862
28/11/2018,#####,22,4018,1875,5893
28/11/2018,#####,23,3880,1880,5760
28/11/2018,#####,0,4096,1864,5960
29/11/2018,#####,1,3665,1881,5546
29/11/2018,#####,2,3415,1836,5251
29/11/2018,#####,3,3611,1839,5450
29/11/2018,#####,4,3581,1802,5383
29/11/2018,#####,5,3703,1763,5466
29/11/2018,#####,6,3519,1802,5321
29/11/2018,#####,7,3613,1866,5479
29/11/2018,#####,8,3963,1867,5830
29/11/2018,#####,9,3718,1838,5556
29/11/2018,#####,10,3611,1823,5434
29/11/2018,#####,11,3354,1800,5154
29/11/2018,#####,12,3518,1798,5316
29/11/2018,#####,13,3573,1792,5365
29/11/2018,#####,14,3740,1803,5543
29/11/2018,#####,15,3606,1764,5370
29/11/2018,#####,16,3743,1764,5507
29/11/2018,#####,17,4007,1819,5826
29/11/2018,#####,18,4492,1815,6307
29/11/2018,#####,19,4122,1834,5956
29/11/2018,#####,20,4082,1826,5908
29/11/2018,#####,21,4320,1768,6088
29/11/2018,#####,22,4254,1761,6015
29/11/2018,#####,23,3634,1707,5341
29/11/2018,#####,0,3470,1669,5139
30/11/2018,#####,1,3513,1644,5157
30/11/2018,#####,2,3459,1600,5059
30/11/2018,#####,3,3474,1593,5067
30/11/2018,#####,4,3373,1617,4990
30/11/2018,#####,5,3535,1587,5122
30/11/2018,#####,6,3407,1570,4977
30/11/2018,#####,7,3369,1562,4931
30/11/2018,#####,8,3873,1570,5443
30/11/2018,#####,9,4031,1591,5622
30/11/2018,#####,10,3619,1578,5197
30/11/2018,#####,11,3788,1629,5417
30/11/2018,#####,12,3802,1622,5424
30/11/2018,#####,13,3935,1584,5519
30/11/2018,#####,14,3810,1471,5281
30/11/2018,#####,15,4183,1426,5609
30/11/2018,#####,16,4215,1495,5710
30/11/2018,#####,17,4058,1502,5560
30/11/2018,#####,18,3494,1474,4968
30/11/2018,#####,19,3078,1454,4532
30/11/2018,#####,20,3962,1454,5416
30/11/2018,#####,21,3929,1435,5364
30/11/2018,#####,22,3733,1396,5129
30/11/2018,#####,23,3603,1351,4954
30/11/2018,#####,0,3548,1292,4840
01/12/2018,#####,1,2858,1220,4078
01/12/2018,#####,2,2806,1110,3916
01/12/2018,#####,3,2852,1078,3930
01/12/2018,#####,4,2923,1119,4042
01/12/2018,#####,5,2722,1141,3863
01/12/2018,#####,6,2541,1142,3683
01/12/2018,#####,7,2558,1176,3734
01/12/2018,#####,8,2794,1240,4034
01/12/2018,#####,9,2813,1254,4067
01/12/2018,#####,10,3007,1276,4283
01/12/2018,#####,11,2941,1374,4315
01/12/2018,#####,12,2636,1482,4118
01/12/2018,#####,13,2482,1428,3910
01/12/2018,#####,14,2941,1332,4273
01/12/2018,#####,15,2363,1307,3670
01/12/2018,#####,16,2368,1381,3749
01/12/2018,#####,17,2557,1331,3888
01/12/2018,#####,18,2830,1308,4138
01/12/2018,#####,19,2768,1372,4140
01/12/2018,#####,20,3115,1396,4511
01/12/2018,#####,21,2867,1399,4266
01/12/2018,#####,22,2503,1300,3803
01/12/2018,#####,23,2393,1168,3561
01/12/2018,#####,0,2249,1062,3311
02/12/2018,#####,1,2009,974,2983
02/12/2018,#####,2,2056,976,3032
02/12/2018,#####,3,2290,950,3240
02/12/2018,#####,4,2490,992,3482
02/12/2018,#####,5,2560,1041,3601
02/12/2018,#####,6,2464,1209,3673
02/12/2018,#####,7,2262,1279,3541
02/12/2018,#####,8,2449,1347,3796
02/12/2018,#####,9,2805,1391,4196
02/12/2018,#####,10,2993,1382,4375
02/12/2018,#####,11,2995,1379,4374
02/12/2018,#####,12,3024,1329,4353
02/12/2018,#####,13,2969,1305,4274
02/12/2018,#####,14,2835,1257,4092
02/12/2018,#####,15,2730,1212,3942
02/12/2018,#####,16,2634,1231,3865
02/12/2018,#####,17,2614,1200,3814
02/12/2018,#####,18,2637,1208,3845
02/12/2018,#####,19,2579,1255,3834
02/12/2018,#####,20,2519,1363,3882
02/12/2018,#####,21,2489,1350,3839
02/12/2018,#####,22,2354,1238,3592
02/12/2018,#####,23,2045,1255,3300
02/12/2018,#####,0,1852,1098,2950
03/12/2018,#####,1,1782,852,2634
03/12/2018,#####,2,1798,847,2645
03/12/2018,#####,3,1871,973,2844
03/12/2018,#####,4,2085,1107,3192
03/12/2018,#####,5,2316,1051,3367
03/12/2018,#####,6,2691,1210,3901
03/12/2018,#####,7,3352,1298,4650
03/12/2018,#####,8,3519,1349,4868
03/12/2018,#####,9,3381,1430,4811
03/12/2018,#####,10,3470,1447,4917
03/12/2018,#####,11,3709,1391,5100
03/12/2018,#####,12,4207,1342,5549
03/12/2018,#####,13,4508,1355,5863
03/12/2018,#####,14,4226,1412,5638
03/12/2018,#####,15,3898,1371,5269
03/12/2018,#####,16,4008,1443,5451
03/12/2018,#####,17,4047,1446,5493
03/12/2018,#####,18,3994,1382,5376
03/12/2018,#####,19,3424,1374,4798
03/12/2018,#####,20,3215,1309,4524
03/12/2018,#####,21,3086,1164,4250
03/12/2018,#####,22,3003,1128,4131
03/12/2018,#####,23,3657,1131,4788
03/12/2018,#####,0,3919,1145,5064
04/12/2018,#####,1,3883,1162,5045
04/12/2018,#####,2,3661,1138,4799
04/12/2018,#####,3,3378,1268,4646
04/12/2018,#####,4,3434,1305,4739
04/12/2018,#####,5,3700,1364,5064
04/12/2018,#####,6,3892,1503,5395
04/12/2018,#####,7,3924,1597,5521
04/12/2018,#####,8,4436,1642,6078
04/12/2018,#####,9,4437,1672,6109
04/12/2018,#####,10,4515,1717,6232
04/12/2018,#####,11,4706,1753,6459
04/12/2018,#####,12,5273,1801,7074
04/12/2018,#####,13,5029,1838,6867
04/12/2018,#####,14,5031,1762,6793
04/12/2018,#####,15,4643,1695,6338
04/12/2018,#####,16,4579,1665,6244
04/12/2018,#####,17,4253,1636,5889
04/12/2018,#####,18,4147,1646,5793
04/12/2018,#####,19,3644,1635,5279
04/12/2018,#####,20,3413,1625,5038
04/12/2018,#####,21,2969,1580,4549
04/12/2018,#####,22,2605,1465,4070
04/12/2018,#####,23,2349,1353,3702
04/12/2018,#####,0,2133,1225,3358
05/12/2018,#####,1,1740,1071,2811
05/12/2018,#####,2,1732,1094,2826
05/12/2018,#####,3,1608,1131,2739
05/12/2018,#####,4,1610,1050,2660
05/12/2018,#####,5,1652,1039,2691
05/12/2018,#####,6,1871,1029,2900
05/12/2018,#####,7,1738,1145,2883
05/12/2018,#####,8,2272,1253,3525
05/12/2018,#####,9,2338,1217,3555
05/12/2018,#####,10,2366,1272,3638
05/12/2018,#####,11,2168,1234,3402
05/12/2018,#####,12,2092,1277,3369
05/12/2018,#####,13,2050,1225,3275
05/12/2018,#####,14,2116,1250,3366
05/12/2018,#####,15,2397,1234,3631
05/12/2018,#####,16,2528,1185,3713
05/12/2018,#####,17,3063,1121,4184
05/12/2018,#####,18,3074,1122,4196
05/12/2018,#####,19,2481,1114,3595
05/12/2018,#####,20,2811,1158,3969
05/12/2018,#####,21,2899,1130,4029
05/12/2018,#####,22,2752,1045,3797
05/12/2018,#####,23,2455,989,3444
05/12/2018,#####,0,2280,1026,3306
06/12/2018,#####,1,1894,1037,2931
06/12/2018,#####,2,2030,1127,3157
06/12/2018,#####,3,2116,1132,3248
06/12/2018,#####,4,2152,1067,3219
06/12/2018,#####,5,1804,1012,2816
06/12/2018,#####,6,2011,1081,3092
06/12/2018,#####,7,2559,1111,3670
06/12/2018,#####,8,2695,1217,3912
06/12/2018,#####,9,2784,1171,3955
06/12/2018,#####,10,2780,1120,3900
06/12/2018,#####,11,2782,1120,3902
06/12/2018,#####,12,2832,1154,3986
06/12/2018,#####,13,2716,1145,3861
06/12/2018,#####,14,2785,1245,4030
06/12/2018,#####,15,3002,1224,4226
06/12/2018,#####,16,3165,1199,4364
06/12/2018,#####,17,3221,1177,4398
06/12/2018,#####,18,3368,1270,4638
06/12/2018,#####,19,3352,1431,4783
06/12/2018,#####,20,3380,1441,4821
06/12/2018,#####,21,3884,1347,5231
06/12/2018,#####,22,3848,1235,5083
06/12/2018,#####,23,3502,1212,4714
06/12/2018,#####,0,3226,1312,4538
07/12/2018,#####,1,3020,1328,4348
07/12/2018,#####,2,2886,1399,4285
07/12/2018,#####,3,2570,1287,3857
07/12/2018,#####,4,2249,1203,3452
07/12/2018,#####,5,2277,1123,3400
07/12/2018,#####,6,2058,1032,3090
07/12/2018,#####,7,2153,1030,3183
07/12/2018,#####,8,2614,1101,3715
07/12/2018,#####,9,2369,1055,3424
07/12/2018,#####,10,2021,1015,3036
07/12/2018,#####,11,2476,960,3436
07/12/2018,#####,12,2948,1022,3970
07/12/2018,#####,13,3393,1171,4564
07/12/2018,#####,14,3413,1300,4713
07/12/2018,#####,15,4002,1392,5394
07/12/2018,#####,16,4468,1467,5935
07/12/2018,#####,17,4618,1507,6125
07/12/2018,#####,18,4393,1519,5912
07/12/2018,#####,19,4207,1534,5741
07/12/2018,#####,20,4061,1457,5518
07/12/2018,#####,21,3798,1495,5293
07/12/2018,#####,22,3546,1382,4928
07/12/2018,#####,23,3253,1308,4561
07/12/2018,#####,0,2641,1315,3956
08/12/2018,#####,1,2964,1363,4327
08/12/2018,#####,2,2873,1330,4203
08/12/2018,#####,3,2511,1317,3828
08/12/2018,#####,4,2111,1307,3418
08/12/2018,#####,5,2263,1350,3613
08/12/2018,#####,6,2322,1411,3733
08/12/2018,#####,7,2413,1481,3894
08/12/2018,#####,8,2700,1527,4227
08/12/2018,#####,9,3035,1617,4652
08/12/2018,#####,10,3138,1654,4792
08/12/2018,#####,11,3329,1690,5019
08/12/2018,#####,12,3484,1651,5135
08/12/2018,#####,13,3581,1622,5203
08/12/2018,#####,14,3538,1653,5191
08/12/2018,#####,15,3478,1596,5074
08/12/2018,#####,16,3545,1596,5141
08/12/2018,#####,17,3825,1649,5474
08/12/2018,#####,18,3910,1676,5586
08/12/2018,#####,19,4000,1693,5693
08/12/2018,#####,20,4109,1645,5754
08/12/2018,#####,21,3825,1586,5411
08/12/2018,#####,22,3671,1513,5184
08/12/2018,#####,23,3426,1428,4854
08/12/2018,#####,0,3023,1416,4439
09/12/2018,#####,1,2035,1417,3452
09/12/2018,#####,2,1737,1345,3082
09/12/2018,#####,3,1559,1088,2647
09/12/2018,#####,4,1597,926,2523
09/12/2018,#####,5,1528,977,2505
09/12/2018,#####,6,1696,1123,2819
09/12/2018,#####,7,2068,1306,3374
09/12/2018,#####,8,2310,1370,3680
09/12/2018,#####,9,2590,1457,4047
09/12/2018,#####,10,2716,1502,4218
09/12/2018,#####,11,2906,1462,4368
09/12/2018,#####,12,2885,1388,4273
09/12/2018,#####,13,3066,1393,4459
09/12/2018,#####,14,3085,1406,4491
09/12/2018,#####,15,3096,1430,4526
09/12/2018,#####,16,3182,1400,4582
09/12/2018,#####,17,3156,1417,4573
09/12/2018,#####,18,3242,1486,4728
09/12/2018,#####,19,3395,1539,4934
09/12/2018,#####,20,3482,1518,5000
09/12/2018,#####,21,3524,1324,4848
09/12/2018,#####,22,3391,1139,4530
09/12/2018,#####,23,3050,1144,4194
09/12/2018,#####,0,3139,1256,4395
10/12/2018,#####,1,2873,1164,4037
10/12/2018,#####,2,2802,1165,3967
10/12/2018,#####,3,2810,1315,4125
10/12/2018,#####,4,3013,1447,4460
10/12/2018,#####,5,3003,1479,4482
10/12/2018,#####,6,3553,1599,5152
10/12/2018,#####,7,3743,1709,5452
10/12/2018,#####,8,3689,1734,5423
10/12/2018,#####,9,3634,1732,5366
10/12/2018,#####,10,3837,1723,5560
10/12/2018,#####,11,4222,1727,5949
10/12/2018,#####,12,4848,1714,6562
10/12/2018,#####,13,4918,1713,6631
10/12/2018,#####,14,4939,1746,6685
10/12/2018,#####,15,4258,1723,5981
10/12/2018,#####,16,3713,1700,5413
10/12/2018,#####,17,3543,1664,5207
10/12/2018,#####,18,3649,1646,5295
10/12/2018,#####,19,3811,1679,5490
10/12/2018,#####,20,3438,1670,5108
10/12/2018,#####,21,3756,1621,5377
10/12/2018,#####,22,3903,1667,5570
10/12/2018,#####,23,3586,1703,5289
10/12/2018,#####,0,3314,1711,5025
11/12/2018,#####,1,2754,1676,4430
11/12/2018,#####,2,2912,1600,4512
11/12/2018,#####,3,2975,1607,4582
11/12/2018,#####,4,3108,1576,4684
11/12/2018,#####,5,2971,1457,4428
11/12/2018,#####,6,2996,1458,4454
11/12/2018,#####,7,3276,1510,4786
11/12/2018,#####,8,3060,1477,4537
11/12/2018,#####,9,3332,1438,4770
11/12/2018,#####,10,3108,1408,4516
11/12/2018,#####,11,2809,1443,4252
11/12/2018,#####,12,3123,1405,4528
11/12/2018,#####,13,3161,1413,4574
11/12/2018,#####,14,3323,1421,4744
11/12/2018,#####,15,3565,1357,4922
11/12/2018,#####,16,3687,1376,5063
11/12/2018,#####,17,3685,1434,5119
11/12/2018,#####,18,3606,1419,5025
11/12/2018,#####,19,3401,1398,4799
11/12/2018,#####,20,3158,1291,4449
11/12/2018,#####,21,2932,1272,4204
11/12/2018,#####,22,2541,1236,3777
11/12/2018,#####,23,2317,1176,3493
11/12/2018,#####,0,2206,1137,3343
12/12/2018,#####,1,1912,1091,3003
12/12/2018,#####,2,1841,1055,2896
12/12/2018,#####,3,1784,997,2781
12/12/2018,#####,4,1747,1008,2755
12/12/2018,#####,5,1783,1028,2811
12/12/2018,#####,6,1938,1119,3057
12/12/2018,#####,7,2360,1123,3483
12/12/2018,#####,8,2777,1243,4020
12/12/2018,#####,9,2890,1286,4176
12/12/2018,#####,10,2855,1274,4129
12/12/2018,#####,11,2734,1285,4019
12/12/2018,#####,12,2697,1337,4034
12/12/2018,#####,13,2631,1349,3980
12/12/2018,#####,14,2608,1392,4000
12/12/2018,#####,15,2579,1327,3906
12/12/2018,#####,16,2573,1322,3895
12/12/2018,#####,17,2723,1336,4059
12/12/2018,#####,18,2840,1364,4204
12/12/2018,#####,19,2788,1404,4192
12/12/2018,#####,20,2713,1378,4091
12/12/2018,#####,21,2672,1220,3892
12/12/2018,#####,22,2493,1112,3605
12/12/2018,#####,23,2445,1055,3500
12/12/2018,#####,0,2234,939,3173
13/12/2018,#####,1,2107,899,3006
13/12/2018,#####,2,1935,872,2807
13/12/2018,#####,3,1947,885,2832
13/12/2018,#####,4,1921,871,2792
13/12/2018,#####,5,1998,864,2862
13/12/2018,#####,6,2264,955,3219
13/12/2018,#####,7,2742,1060,3802
13/12/2018,#####,8,2994,1257,4251
13/12/2018,#####,9,3061,1341,4402
13/12/2018,#####,10,3142,1421,4563
13/12/2018,#####,11,3011,1408,4419
13/12/2018,#####,12,3197,1468,4665
13/12/2018,#####,13,3226,1430,4656
13/12/2018,#####,14,3264,1361,4625
13/12/2018,#####,15,3248,1429,4677
13/12/2018,#####,16,3292,1390,4682
13/12/2018,#####,17,3192,1532,4724
13/12/2018,#####,18,3207,1557,4764
13/12/2018,#####,19,3303,1505,4808
13/12/2018,#####,20,3111,1479,4590
13/12/2018,#####,21,2983,1464,4447
13/12/2018,#####,22,2878,1347,4225
13/12/2018,#####,23,2729,1192,3921
13/12/2018,#####,0,2647,996,3643
14/12/2018,#####,1,2610,817,3427
14/12/2018,#####,2,2438,775,3213
14/12/2018,#####,3,2443,739,3182
14/12/2018,#####,4,2358,728,3086
14/12/2018,#####,5,2374,734,3108
14/12/2018,#####,6,2410,780,3190
14/12/2018,#####,7,2895,842,3737
14/12/2018,#####,8,3147,892,4039
14/12/2018,#####,9,3266,986,4252
14/12/2018,#####,10,3381,990,4371
14/12/2018,#####,11,3264,983,4247
14/12/2018,#####,12,3236,993,4229
14/12/2018,#####,13,3278,998,4276
14/12/2018,#####,14,3201,995,4196
14/12/2018,#####,15,3047,1100,4147
14/12/2018,#####,16,3117,1115,4232
14/12/2018,#####,17,3283,1092,4375
14/12/2018,#####,18,3278,1088,4366
14/12/2018,#####,19,3273,1041,4314
14/12/2018,#####,20,3085,950,4035
14/12/2018,#####,21,2965,894,3859
14/12/2018,#####,22,2657,805,3462
14/12/2018,#####,23,2484,776,3260
14/12/2018,#####,0,2303,742,3045
15/12/2018,#####,1,2456,714,3170
15/12/2018,#####,2,2229,672,2901
15/12/2018,#####,3,2213,703,2916
15/12/2018,#####,4,2112,697,2809
15/12/2018,#####,5,2090,661,2751
15/12/2018,#####,6,2143,626,2769
15/12/2018,#####,7,2239,628,2867
15/12/2018,#####,8,2414,642,3056
15/12/2018,#####,9,2596,698,3294
15/12/2018,#####,10,2702,730,3432
15/12/2018,#####,11,2943,766,3709
15/12/2018,#####,12,3142,776,3918
15/12/2018,#####,13,3231,781,4012
15/12/2018,#####,14,3292,780,4072
15/12/2018,#####,15,3330,785,4115
15/12/2018,#####,16,3321,773,4094
15/12/2018,#####,17,3353,766,4119
15/12/2018,#####,18,3702,779,4481
15/12/2018,#####,19,3734,766,4500
15/12/2018,#####,20,3686,781,4467
15/12/2018,#####,21,3790,751,4541
15/12/2018,#####,22,3790,742,4532
15/12/2018,#####,23,3529,885,4414
15/12/2018,#####,0,3285,1023,4308
16/12/2018,#####,1,3421,1102,4523
16/12/2018,#####,2,3643,1139,4782
16/12/2018,#####,3,3356,1151,4507
16/12/2018,#####,4,3547,1132,4679
16/12/2018,#####,5,3543,1155,4698
16/12/2018,#####,6,3591,1185,4776
16/12/2018,#####,7,3735,1260,4995
16/12/2018,#####,8,3642,1336,4978
16/12/2018,#####,9,3625,1347,4972
16/12/2018,#####,10,3944,1360,5304
16/12/2018,#####,11,4205,1412,5617
16/12/2018,#####,12,4513,1393,5906
16/12/2018,#####,13,4258,1305,5563
16/12/2018,#####,14,4117,1152,5269
16/12/2018,#####,15,3761,1048,4809
16/12/2018,#####,16,3503,990,4493
16/12/2018,#####,17,3279,976,4255
16/12/2018,#####,18,3057,993,4050
16/12/2018,#####,19,2890,966,3856
16/12/2018,#####,20,2714,938,3652
16/12/2018,#####,21,2551,862,3413
16/12/2018,#####,22,2466,788,3254
16/12/2018,#####,23,2335,753,3088
16/12/2018,#####,0,2247,713,2960
17/12/2018,#####,1,1953,665,2618
17/12/2018,#####,2,1779,669,2448
17/12/2018,#####,3,1778,657,2435
17/12/2018,#####,4,1632,656,2288
17/12/2018,#####,5,1558,664,2222
17/12/2018,#####,6,1658,736,2394
17/12/2018,#####,7,2255,743,2998
17/12/2018,#####,8,2548,788,3336
17/12/2018,#####,9,2661,893,3554
17/12/2018,#####,10,2639,957,3596
17/12/2018,#####,11,2620,937,3557
17/12/2018,#####,12,2653,1104,3757
17/12/2018,#####,13,2663,1118,3781
17/12/2018,#####,14,2583,1080,3663
17/12/2018,#####,15,2484,1074,3558
17/12/2018,#####,16,2674,1108,3782
17/12/2018,#####,17,2843,1146,3989
17/12/2018,#####,18,2657,1128,3785
17/12/2018,#####,19,2730,1126,3856
17/12/2018,#####,20,2736,1138,3874
17/12/2018,#####,21,2521,1138,3659
17/12/2018,#####,22,2282,1093,3375
17/12/2018,#####,23,2064,1062,3126
17/12/2018,#####,0,1933,1018,2951
18/12/2018,#####,1,2096,997,3093
18/12/2018,#####,2,2134,1035,3169
18/12/2018,#####,3,2156,999,3155
18/12/2018,#####,4,2115,997,3112
18/12/2018,#####,5,2110,976,3086
18/12/2018,#####,6,2433,974,3407
18/12/2018,#####,7,2703,991,3694
18/12/2018,#####,8,2869,1032,3901
18/12/2018,#####,9,2784,1092,3876
18/12/2018,#####,10,2817,1090,3907
18/12/2018,#####,11,2897,1113,4010
18/12/2018,#####,12,3039,1112,4151
18/12/2018,#####,13,3133,1109,4242
18/12/2018,#####,14,2870,1107,3977
18/12/2018,#####,15,2940,1072,4012
18/12/2018,#####,16,3106,1078,4184
18/12/2018,#####,17,3291,1084,4375
18/12/2018,#####,18,3415,1133,4548
18/12/2018,#####,19,3480,1227,4707
18/12/2018,#####,20,3299,1284,4583
18/12/2018,#####,21,3332,1329,4661
18/12/2018,#####,22,3279,1285,4564
18/12/2018,#####,23,3203,1316,4519
18/12/2018,#####,0,3107,1356,4463
19/12/2018,#####,1,3093,1321,4414
19/12/2018,#####,2,3302,1396,4698
19/12/2018,#####,3,3243,1510,4753
19/12/2018,#####,4,3049,1547,4596
19/12/2018,#####,5,3217,1593,4810
19/12/2018,#####,6,3739,1677,5416
19/12/2018,#####,7,4065,1696,5761
19/12/2018,#####,8,4313,1513,5826
19/12/2018,#####,9,3847,1534,5381
19/12/2018,#####,10,3670,1697,5367
19/12/2018,#####,11,3795,1721,5516
19/12/2018,#####,12,3831,1673,5504
19/12/2018,#####,13,3678,1517,5195
19/12/2018,#####,14,3722,1394,5116
19/12/2018,#####,15,3486,1274,4760
19/12/2018,#####,16,3170,1249,4419
19/12/2018,#####,17,3261,1249,4510
19/12/2018,#####,18,3043,1211,4254
19/12/2018,#####,19,2805,1234,4039
19/12/2018,#####,20,2862,1127,3989
19/12/2018,#####,21,2879,1050,3929
19/12/2018,#####,22,2795,1081,3876
19/12/2018,#####,23,2665,1015,3680
19/12/2018,#####,0,2570,1008,3578
20/12/2018,#####,1,2379,1008,3387
20/12/2018,#####,2,2208,1012,3220
20/12/2018,#####,3,2282,1016,3298
20/12/2018,#####,4,2109,1025,3134
20/12/2018,#####,5,2222,1042,3264
20/12/2018,#####,6,2551,1049,3600
20/12/2018,#####,7,2845,1033,3878
20/12/2018,#####,8,3063,1070,4133
20/12/2018,#####,9,3063,1125,4188
20/12/2018,#####,10,3035,1119,4154
20/12/2018,#####,11,3109,1137,4246
20/12/2018,#####,12,3148,1205,4353
20/12/2018,#####,13,3175,1134,4309
20/12/2018,#####,14,3148,1124,4272
20/12/2018,#####,15,3139,1116,4255
20/12/2018,#####,16,3267,1111,4378
20/12/2018,#####,17,3370,1117,4487
20/12/2018,#####,18,3568,1147,4715
20/12/2018,#####,19,3534,1091,4625
20/12/2018,#####,20,3360,1057,4417
20/12/2018,#####,21,3203,1043,4246
20/12/2018,#####,22,2964,1019,3983
20/12/2018,#####,23,2900,990,3890
20/12/2018,#####,0,2639,996,3635
21/12/2018,#####,1,2524,1009,3533
21/12/2018,#####,2,2505,1084,3589
21/12/2018,#####,3,2496,1124,3620
21/12/2018,#####,4,2408,1134,3542
21/12/2018,#####,5,2480,1164,3644
21/12/2018,#####,6,2472,1130,3602
21/12/2018,#####,7,2539,1231,3770
21/12/2018,#####,8,3188,1283,4471
21/12/2018,#####,9,3421,1311,4732
21/12/2018,#####,10,3361,1333,4694
21/12/2018,#####,11,3420,1349,4769
21/12/2018,#####,12,3360,1377,4737
21/12/2018,#####,13,3442,1447,4889
21/12/2018,#####,14,3543,1462,5005
21/12/2018,#####,15,3397,1509,4906
21/12/2018,#####,16,3456,1624,5080
21/12/2018,#####,17,3508,1671,5179
21/12/2018,#####,18,3530,1625,5155
21/12/2018,#####,19,3348,1616,4964
21/12/2018,#####,20,3392,1607,4999
21/12/2018,#####,21,3462,1610,5072
21/12/2018,#####,22,3243,1515,4758
21/12/2018,#####,23,2951,1333,4284
21/12/2018,#####,0,2721,1217,3938
22/12/2018,#####,1,2420,1182,3602
22/12/2018,#####,2,2195,1201,3396
22/12/2018,#####,3,2043,1183,3226
22/12/2018,#####,4,1763,1166,2929
22/12/2018,#####,5,1859,1108,2967
22/12/2018,#####,6,2007,1042,3049
22/12/2018,#####,7,2047,1051,3098
22/12/2018,#####,8,2136,1013,3149
22/12/2018,#####,9,2184,979,3163
22/12/2018,#####,10,2176,998,3174
22/12/2018,#####,11,1901,1013,2914
22/12/2018,#####,12,1751,1037,2788
22/12/2018,#####,13,1703,1029,2732
22/12/2018,#####,14,1869,1008,2877
22/12/2018,#####,15,1687,1010,2697
22/12/2018,#####,16,1683,996,2679
22/12/2018,#####,17,1816,1002,2818
22/12/2018,#####,18,2056,996,3052
22/12/2018,#####,19,2110,984,3094
22/12/2018,#####,20,2092,988,3080
22/12/2018,#####,21,1862,930,2792
22/12/2018,#####,22,1804,914,2718
22/12/2018,#####,23,1636,913,2549
22/12/2018,#####,0,1814,912,2726
23/12/2018,#####,1,1622,915,2537
23/12/2018,#####,2,1619,918,2537
23/12/2018,#####,3,1658,963,2621
23/12/2018,#####,4,1609,977,2586
23/12/2018,#####,5,1644,1048,2692
23/12/2018,#####,6,1616,1120,2736
23/12/2018,#####,7,1601,1286,2887
23/12/2018,#####,8,1730,1434,3164
23/12/2018,#####,9,1843,1502,3345
23/12/2018,#####,10,1833,1474,3307
23/12/2018,#####,11,1785,1381,3166
23/12/2018,#####,12,1696,1229,2925
23/12/2018,#####,13,1764,1093,2857
23/12/2018,#####,14,2045,986,3031
23/12/2018,#####,15,1997,943,2940
23/12/2018,#####,16,2049,944,2993
23/12/2018,#####,17,2322,968,3290
23/12/2018,#####,18,2612,1005,3617
23/12/2018,#####,19,2615,1038,3653
23/12/2018,#####,20,2552,1063,3615
23/12/2018,#####,21,2243,1119,3362
23/12/2018,#####,22,1827,1117,2944
23/12/2018,#####,23,1788,1113,2901
23/12/2018,#####,0,1632,1126,2758
24/12/2018,#####,1,1200,1196,2396
24/12/2018,#####,2,1156,1181,2337
24/12/2018,#####,3,1254,1082,2336
24/12/2018,#####,4,1444,1054,2498
24/12/2018,#####,5,1599,1078,2677
24/12/2018,#####,6,1681,1083,2764
24/12/2018,#####,7,1702,1136,2838
24/12/2018,#####,8,2048,1124,3172
24/12/2018,#####,9,2344,1160,3504
24/12/2018,#####,10,2597,1227,3824
24/12/2018,#####,11,2841,1245,4086
24/12/2018,#####,12,3001,1216,4217
24/12/2018,#####,13,3256,1227,4483
24/12/2018,#####,14,3284,1436,4720
24/12/2018,#####,15,3248,1493,4741
24/12/2018,#####,16,3103,1569,4672
24/12/2018,#####,17,3100,1546,4646
24/12/2018,#####,18,3199,1511,4710
24/12/2018,#####,19,3170,1425,4595
24/12/2018,#####,20,3020,1322,4342
24/12/2018,#####,21,3407,1282,4689
24/12/2018,#####,22,3638,1442,5080
24/12/2018,#####,23,3792,1548,5340
24/12/2018,#####,0,3435,1574,5009
25/12/2018,#####,1,3383,1554,4937
25/12/2018,#####,2,3435,1513,4948
25/12/2018,#####,3,3047,1467,4514
25/12/2018,#####,4,3520,1474,4994
25/12/2018,#####,5,3477,1484,4961
25/12/2018,#####,6,3278,1518,4796
25/12/2018,#####,7,2864,1569,4433
25/12/2018,#####,8,2941,1614,4555
25/12/2018,#####,9,3566,1669,5235
25/12/2018,#####,10,3816,1727,5543
25/12/2018,#####,11,3784,1700,5484
25/12/2018,#####,12,3861,1721,5582
25/12/2018,#####,13,3838,1666,5504
25/12/2018,#####,14,3545,1647,5192
25/12/2018,#####,15,3510,1636,5146
25/12/2018,#####,16,3563,1639,5202
25/12/2018,#####,17,3809,1762,5571
25/12/2018,#####,18,3932,1827,5759
25/12/2018,#####,19,4119,1839,5958
25/12/2018,#####,20,4125,1777,5902
25/12/2018,#####,21,4147,1721,5868
25/12/2018,#####,22,3866,1705,5571
25/12/2018,#####,23,3355,1677,5032
25/12/2018,#####,0,3380,1657,5037
26/12/2018,#####,1,2911,1587,4498
26/12/2018,#####,2,2276,1513,3789
26/12/2018,#####,3,2338,1318,3656
26/12/2018,#####,4,2140,1222,3362
26/12/2018,#####,5,2312,1174,3486
26/12/2018,#####,6,2838,1261,4099
26/12/2018,#####,7,3043,1270,4313
26/12/2018,#####,8,3072,1196,4268
26/12/2018,#####,9,2615,1169,3784
26/12/2018,#####,10,2429,1236,3665
26/12/2018,#####,11,2327,1257,3584
26/12/2018,#####,12,2366,1322,3688
26/12/2018,#####,13,2885,1310,4195
26/12/2018,#####,14,2805,1405,4210
26/12/2018,#####,15,3228,1388,4616
26/12/2018,#####,16,3155,1314,4469
26/12/2018,#####,17,3090,1247,4337
26/12/2018,#####,18,2895,1417,4312
26/12/2018,#####,19,2955,1358,4313
26/12/2018,#####,20,3043,1403,4446
26/12/2018,#####,21,2819,1442,4261
26/12/2018,#####,22,2731,1343,4074
26/12/2018,#####,23,2776,1353,4129
26/12/2018,#####,0,2714,1384,4098
27/12/2018,#####,1,3139,1392,4531
27/12/2018,#####,2,2705,1383,4088
27/12/2018,#####,3,2689,1415,4104
27/12/2018,#####,4,2897,1390,4287
27/12/2018,#####,5,2916,1346,4262
27/12/2018,#####,6,3235,1341,4576
27/12/2018,#####,7,3126,1367,4493
27/12/2018,#####,8,2670,1360,4030
27/12/2018,#####,9,2775,1384,4159
27/12/2018,#####,10,2917,1433,4350
27/12/2018,#####,11,2942,1435,4377
27/12/2018,#####,12,3229,1456,4685
27/12/2018,#####,13,3460,1411,4871
27/12/2018,#####,14,3453,1422,4875
27/12/2018,#####,15,3181,1487,4668
27/12/2018,#####,16,2948,1454,4402
27/12/2018,#####,17,3069,1436,4505
27/12/2018,#####,18,3306,1388,4694
27/12/2018,#####,19,3219,1328,4547
27/12/2018,#####,20,3214,1270,4484
27/12/2018,#####,21,3203,1358,4561
27/12/2018,#####,22,3239,1369,4608
27/12/2018,#####,23,3413,1365,4778
27/12/2018,#####,0,3391,1321,4712
28/12/2018,#####,1,3388,1275,4663
28/12/2018,#####,2,3138,1222,4360
28/12/2018,#####,3,2978,1175,4153
28/12/2018,#####,4,2742,1130,3872
28/12/2018,#####,5,2560,1128,3688
28/12/2018,#####,6,2495,1062,3557
28/12/2018,#####,7,2486,937,3423
28/12/2018,#####,8,2483,883,3366
28/12/2018,#####,9,2564,1020,3584
28/12/2018,#####,10,2607,1080,3687
28/12/2018,#####,11,2812,1115,3927
28/12/2018,#####,12,2743,1117,3860
28/12/2018,#####,13,2872,1054,3926
28/12/2018,#####,14,2740,1100,3840
28/12/2018,#####,15,2716,1108,3824
28/12/2018,#####,16,2668,948,3616
28/12/2018,#####,17,2818,926,3744
28/12/2018,#####,18,2810,950,3760
28/12/2018,#####,19,2829,984,3813
28/12/2018,#####,20,2760,1005,3765
28/12/2018,#####,21,2630,1060,3690
28/12/2018,#####,22,2526,1081,3607
28/12/2018,#####,23,2661,1146,3807
28/12/2018,#####,0,2695,1136,3831
29/12/2018,#####,1,2645,1214,3859
29/12/2018,#####,2,2536,1226,3762
29/12/2018,#####,3,2633,1266,3899
29/12/2018,#####,4,2451,1292,3743
29/12/2018,#####,5,2361,1317,3678
29/12/2018,#####,6,2297,1244,3541
29/12/2018,#####,7,2399,1169,3568
29/12/2018,#####,8,2496,1114,3610
29/12/2018,#####,9,1990,1137,3127
29/12/2018,#####,10,2147,1214,3361
29/12/2018,#####,11,2379,1416,3795
29/12/2018,#####,12,2453,1323,3776
29/12/2018,#####,13,2405,1274,3679
29/12/2018,#####,14,2385,1222,3607
29/12/2018,#####,15,3109,1204,4313
29/12/2018,#####,16,3140,1241,4381
29/12/2018,#####,17,3033,1394,4427
29/12/2018,#####,18,2967,1609,4576
29/12/2018,#####,19,2636,1636,4272
29/12/2018,#####,20,2626,1560,4186
29/12/2018,#####,21,2581,1341,3922
29/12/2018,#####,22,2936,1102,4038
29/12/2018,#####,23,3129,970,4099
29/12/2018,#####,0,3120,938,4058
30/12/2018,#####,1,2992,1013,4005
30/12/2018,#####,2,2771,1214,3985
30/12/2018,#####,3,2520,1324,3844
30/12/2018,#####,4,2508,1394,3902
30/12/2018,#####,5,2527,1374,3901
30/12/2018,#####,6,2225,1195,3420
30/12/2018,#####,7,2308,1246,3554
30/12/2018,#####,8,2705,1160,3865
30/12/2018,#####,9,2978,1266,4244
30/12/2018,#####,10,3055,1280,4335
30/12/2018,#####,11,3265,1362,4627
30/12/2018,#####,12,3441,1469,4910
30/12/2018,#####,13,3407,1478,4885
30/12/2018,#####,14,3114,1473,4587
30/12/2018,#####,15,2830,1408,4238
30/12/2018,#####,16,2482,1286,3768
30/12/2018,#####,17,2249,1200,3449
30/12/2018,#####,18,2353,1198,3551
30/12/2018,#####,19,2291,1156,3447
30/12/2018,#####,20,2079,1103,3182
30/12/2018,#####,21,1973,1060,3033
30/12/2018,#####,22,1775,1046,2821
30/12/2018,#####,23,1697,1012,2709
30/12/2018,#####,0,1721,948,2669
31/12/2018,#####,1,1792,847,2639
31/12/2018,#####,2,1904,746,2650
31/12/2018,#####,3,1873,722,2595
31/12/2018,#####,4,1777,755,2532
31/12/2018,#####,5,1936,751,2687
31/12/2018,#####,6,2276,718,2994
31/12/2018,#####,7,2530,748,3278
31/12/2018,#####,8,2553,869,3422
31/12/2018,#####,9,2615,948,3563
31/12/2018,#####,10,2642,1039,3681
31/12/2018,#####,11,2778,1113,3891
31/12/2018,#####,12,2884,1171,4055
31/12/2018,#####,13,3212,1202,4414
31/12/2018,#####,14,3649,1210,4859
31/12/2018,#####,15,4007,1229,5236
31/12/2018,#####,16,4290,1244,5534
31/12/2018,#####,17,4432,1462,5894
31/12/2018,#####,18,4448,1544,5992
31/12/2018,#####,19,4652,1585,6237
31/12/2018,#####,20,4393,1545,5938
31/12/2018,#####,21,4068,1646,5714
31/12/2018,#####,22,3555,1603,5158
31/12/2018,#####,23,3312,1461,4773
31/12/2018,#####,0,3223,1453,4676
